..........###..............................
..........# #..............................
..........# #..............................
..........# #..............................
..........# #..............................
..........# #..............................
..........# #..............................
.........##+##.............................
.......###   #.............................
.......# #   #.............................
.......# +   #.............................
.......# #   #.............................
.......# #####.............................
.......# #.................................
.......# #.................................
.....###+#.................................
.....#   #.................................
.###.#   #.................................
.# ###   #......##########.................
.#   +   #......#      + #.................
.# # #   ###....#      # #.................
.# # #   + #....#      # #.................
.# ####### #....#      ###.................
.# #.....# #...#####+###...................
.#+#####.# #...# ###   #...................
.#   # ### #...#   # < #...................
.#   #   ###...# # +   #...................
.#   # # #######+# #   #...................
.#   + # ##      ########..................
.#   # # ##      #      #..................
.#   # ####      +      #########..........
.#####+## +      #      +       ###........
..###   # #      #      # # # #   #........
..# +   # ###+####      # # # # # ###......
### #   + #   #.####+#### ##### #   #......
#   #   ### # ###      ####...# # # #......
# # #+###.# #   #      #......### # #......
# ###   #.# ### #      #........### #......
# #   # ### #.# #####+##..........###......
# # # # #   #.#   ### #....................
### ##### ###.# # #   ###......########....
### ###   #...# # # #   #..#####      #....
#   #   # #...##### # # ####   #      ###..
# ### # # #.......#####   ## # +   >  + #..
# #.# # # #...........# # ## # #      # #..
# #.# # ###...........# # ## # #####+## #..
###.# ###.............### ####+###.# ####..
....# #.................# ###    #.# #.....
....###.................#   #    #.# #.....
........................### #    #.# #.....
..........................# +    #.# #.....
..........................###    #.# #.....
............................#    #.###.....
............................######.........
...........................................
...........................................
...........................................
