..................................................
..................................................
..................................................
..................................................
..................................................
..................................................
..................................................
.................................###..............
.................................# #..............
.................................# #..............
.................................# #..............
.................................# #..............
...............................###+#..............
...............................#   #..............
...............................#   #..............
...............................#   #..............
...............................#   #..............
.....................#####.....#   #..............
.....................#   #.######+##..............
.....###.............# # #.#   #   #..............
###### #...........### # #.#   +   #..............
#    # #.......##### # # #.#   #   #######........
#    + #.......#     #+###.#   ###+#     #........
#    #+######..# # # #   ####+##.# #     #........
######      #..# # # #   +    #..# + >   #........
.....#      #..# ### #   #    #..# #     #........
######      ########+#####    #..####+####........
#   ##      + #..#     #####+#####..# ###.........
# # ##      # #..#     #   #     ####   #.........
# # ##      # ####     +   + <   + ## # #.........
# # #########+## +     #   #     # #### #.........
###+####.#     # #     #   ##+####   ## #.........
..#    ###     + ##+#####+###   ## # ## #.........
..#    # +     # ##   #.# #.# # #### ####.........
..#    + ###+### ## # #.# #.# # #..# #............
..#    # #.# ###### # ### #.# # #..# #............
..#    # #.#   #..# # #   #######..###............
.###+#####.# # #### # # #   #.....................
.#     #...###   ## # # ### ###...................
.# # # #####.# # ###### #.#   #...................
.# # #     #.# #   #..###.### #...................
.# ### # # #.### # #........# #...................
.# #.# # # #...# # ###......# #...................
.# #.### ###...# #   #......# #...................
.###...# #.....### # #......###...................
.......###.......# # #............................
.................### ###..........................
...................#   #..........................
...................# # #..........................
...................### ###........................
.....................#   #........................
.....................# # #........................
.....................# # #........................
.....................### #........................
.......................###........................
