.............................................
.............................................
.............................................
.............................................
.........#######.............................
.......###     #.............................
.......# #     #.............................
.......# +   < #.............................
.......# #     #.............................
.......# #     #.............................
.......# #######.............................
......##+##..................................
..#####   #..................................
###   +   #..................................
#   # #   #..................................
# # # #   #..................................
# # ###   #..................................
# # #.##+##..................................
### #.#   #..................................
..###.#   #..................................
......#   #..................................
......#   #..................................
......# > #.........#######..................
......#   #.........#     #..................
.....###+###........#     ############.......
.....#     #........#     +     ##   ###.....
.....#     #........#     # # # ## #   ###...
.....#     ###......####### # # ## # #   #...
.....#     + #......#####.### # ## ### # #...
.....#     # #......#   #...# #### #.### #...
.....###+### #......#   ##### #..# #...###...
.......#   # #......#   +   #+#### ####......
.....###   # ########   # # #    +    #......
.##### +   ####     +   # # #    # ####......
.#     #   #### # # #+### # +    # #.........
.# # # ##+###   # # #   # ###    # #.........
.# # # ##   # # # # # # # #.###+## #.........
.# ######   + # ### # # ####### ## #.........
.# #..# +   # ###.# # # #     # ## ###.......
.###### #+### #...#######     # ##   #.......
..#     # #######.......#     + #### ###.....
### # # # #     #.......#     ###..#   ###...
#   # ### +     ###.....#     #....# #   #...
# # # #   #     + ###...###+###....### # ###.
# ##### #########   #.....# #........# #   #.
# #...# #.......# # #.....# #........# # # #.
###...# #.......# # #.....# #........# # # #.
......# #.......# # #.....# #........##### #.
......###.......#####.....# #............# #.
..........................# #............###.
..........................###................
.............................................
.............................................
.............................................
.............................................
.............................................
.............................................
