...................................................
...................................................
...................................................
...................................................
...................................................
...................................................
...................................................
...................................................
...................................................
...................................................
.....###.................................###.......
.....# #.................................# #.......
.....# #......###........................# ###.....
.....# ###....# #........................#   #.....
.....#   #....# #....................#####+# #.....
.....# # #....# #....................#     # #.....
.....# # #...##+##.................###     # #.....
.#####+#####.#   #.................# #     # #.....
.#   +     #.#   #...............### +     ###.....
.# # #     #.#   #...........#####   #     #.......
.# # #     ####+##.###.......#   # # #     #.......
.# # #     + +   #.# #.#####.# # # #+#######.......
.# # #     # #   ### #.#   #.# # # #    ###........
.# ###     # #   + # ###   #####+###    + #........
.###.####### #   # # # +   #     + +  > # #........
...........# ##+## # # #   +   < # #    # #........
...........# ## ## #   #   #     # ####+# #........
......######### ## ### #+#######+###..# # #........
......#   ##### ##+##### #.#   # #....# ###........
......#   +   # #    #.# #.#   # #....# #..........
......#   # # # #    ### ###   # #....# #..........
......##### # ###    +     +   # #....###..........
..#########+# # +    # ### #   ###.................
..#   +     ### #    # #.# #   + #####.............
### # #     #   ###+## #.# ###+#     #.............
#   # #     # ##### ####.# #.# # # # #.............
# # # #     + #.#   ###### ### # # # #.............
# # # #     # #.# #     ####   # # # #.............
# #####     # #.# # # # #..# # #######.............
# #...#########.# ### # #..# ###...................
# #.............# #.#####..# #.....................
###.............###........###.....................
