............................................
............................................
............................................
............................................
............................................
............................................
............................................
............................................
............................................
............................................
............................................
............................................
....................###.....................
....................# #.....................
....................# #.....................
....................# #.....................
........###.........# #.....................
........# #..######## ##....................
........# #..#         #..........###.......
........# #..# # # #####........### #.......
.###....# #..# # # #.#####......#   #.......
.# #..###+#### # ###.#   ###....# # #.......
.# #..#     ####+##..#   + #....# # #.......
.# #### >   #     #..#   # #....# # #.......
.# ## +     +     ######## #....# #+########
.# ## #     #     + +   ## #....# #      + #
##+## #####+#     # #   ##+##...###      # #
#   # #...# #     # #   #   ###.# +      # #
#   ####### ###+#####   #   + ### #      # #
#   +     #   # ###.#   +   #   # ######## #
#   #     # # #   ####+##   # # #+##########
#   #     ### # # ##   ##   ### #     + #...
#####     #.### # ## # ##+###.# #     # #...
....###+####### # ## # ##   #.# +     # ###.
......#      ## #### # ## # ### #     #   #.
......#      ####### # ## #   ####+#### # #.
#######      #       #### # # #..# #### # #.
# +   #      + # # ###..##### #..#   #### #.
# #   #      # # # #........# #### # ######.
# #   +      ### # #........# ##   #   #....
# #   ####+####### #........# ## ##### #####
#######      + #.###........#### #...# #   #
....# +      # #...............# #...# #   #
....# #      # #...............# #...# +   #
....# #      ###...............# #...### < #
....###      #.................###.....#   #
......#      #.........................#####
......########..............................
