.....########.................#########.................###....................
.....#      #.................# #     #.................# #..#######...........
.....###### ############......# #####+######....######### #..#     #...........
.........#      +      #......# # # +      #..### ##      #..#     #...........
.......### ######      #####..# # # #      #..# # ## #### #..#     #...........
.......#   #....#      +   #..#   # #      #..# # ## ####+#..#     ###.........
.......# # #....####+#######..# #####      #..# # ## ##   #..#     + ###.......
.......# # #......#     #######+########+######   ## ## > ######+###   #.......
.......# # #......##### #     #      #.#        #######   +      #.# # #.......
.......# ###........#   +     #      ########## #.#   +   ########.# # #.......
.......# #.......###### #     +      +     #..#+########+##........# # #.......
.......###.......#      #     ####+############    +     #.........#####.......
.................########     #     #######   #    #######.....................
........................#######     #     #+###    #...........................
..........................###.#     #     #   + <  #...........................
...................######## #.#     +     #   #    #######.....................
...................#        #.#     #     +   #    ##    #.....................
...................####+### #.#     ##+####   ###+###### #.....................
....................#    ## ######+##   #.#####.#        #.....................
....................#    ##    +    #   #####...# #### ####....................
....................#    ##### #    #   +   #...# #..#    #....................
...................#####+#.#   #    ###+### ###.###..######....................
...................#     #.##########.#   #   #................................
...................#######............#########................................
