..............................................
..............................................
..............................................
..............................................
............................###...............
............................# #...............
............................# #...............
............................# #...............
............................# #...............
............................# #...............
............................#+###.............
............................#   #.............
..........................###   #.............
......................##### +   #.............
......................#     #   #.............
................###...# # # #   #.............
..............### #...# # #+#####.............
..............#   #...# # #   ######..........
............### # #.### # #   #    #..........
.....#####..#   # #.#   ###   +    #..........
.....#   #..# ###+### ### +   #    #..........
.....# # #..# #     # #.# #   ######..........
.....# # #..###     # #.# #   #...............
.....# # #..# +     ########+###..............
.....#+####.# #     +     #    #..............
.....#    ### #     #     #    #..............
.....#    #   #     #     #    #..............
.....# <  + ####+####     +    #######........
.....#    # #..#   ##     #    +     #........
..####+#### #### # ###+####    # # # ###......
###      #####   # #.# #######+# # #   #......
# +      ###.# # # #.# #   #   ### # # #####..
# #      + #.# ### ### #   # # #.# ###     ###
# ###+#### #.# #.###   # > # # #####.### #   #
# #     ## #.###.### # +   ###     #...# # # #
# # # # ## ###...#   ###   #.# # # #...### # #
### # # ##   #...# # #.#   #.# # # #.....# # #
..### ###### ###.# # #.#+###.#######.....### #
....###....#   ### ###.# ###...............###
...........# #   # #.###   #..................
...........# # # ###.#   # #..................
...........##### #...# # # #..................
...............# #...# ### #..................
...............###...# #.# #..................
.....................# #.# #..................
.....................###.###..................
