.................................................
.................................................
.................................................
.................................................
.................................................
.................................................
.................................................
.................................................
.................................................
.................................................
.................................................
.................................................
.................................................
.................................................
.................................................
.................................................
.................................................
.................................................
.................................................
.................................................
.................................................
.................................................
...#####.........................................
...#   #..............#########..................
...# # ###............#   +   #..................
...# #   #..........###   # # #######............
######+# #.#####....# +   # #       ###..........
#      # #.#   #....# #+### # # # #   #..........
#  >   # #.# # ###### # #.# # # # # # ###........
#      # #.# # ##     # ##### # # # #   #.#######
#      #####+#### # # #   #.### ##### # ### #   #
#      # +    #   # # ### #...# #...# #   # #   #
#      # #  < # ### ### # #...###...# # # # +   #
####+### #    + # ###.# # ###.......##### # #   #
.#   #   #    ### #...# #   #.########### #+#####
.#   # ####+###.# #...# # # #.#   +    ## #    #.
.#   + #..# #####+#####+### #.# # #    ## +    #.
.#   # #### #      #      # ### # #    ####    #.
.#   # ##   +      #      #   # ###    #..##+###.
.##+## ## ###      +      ### #######+####.#   #.
..# ##### ###+######      #.#   ## +     ### # #.
###   #.# #    + #.#      #.# # ## #     #   # #.
#   # #.###    # #.########.# # ## #     + # # #.
# ### #...#    # #..........### ## #     # # ###.
# #.###...########............# ####     # # #...
###...........................###..###########...
