........................................................
........................................................
........................................................
........................................................
........................................................
........................................................
........................................................
........................................................
........................................................
........................................................
........................................................
........................................................
........................................................
........................................................
........................................................
........................................................
........................................................
........................................................
........................................................
........................................................
........................................................
........................................................
........................................................
........................................................
........................................................
........................................................
........................................................
...............................................###......
...............................................# #......
...........................................##### #......
..................##############...........#   # #......
..................#     +      #...........# # #+####...
..................# # # #      #...........# # #    #...
................### # # #      #...........### # >  #...
................#   ### #      #.....###.....# +    ###.
................# # #.# ######+#####.# #.....# #    + #.
..............### # #.######     + #.# #.#####+###### #.
............###   ###....# +     # #.# #.#      #...# #.
............#   # #......# #     # ###+###      #...###.
............# # ###....### #     # #     +      #.......
............# # #..#####   #     # +     #      ###.....
............# # #..#     ######+## #     #      + #.....
............#####..# # # #....# ########+####+### ###...
...................# # # #..### #....#   ##     #   #...
.................### ### ####   ###..# # ## <   # # #...
.................#   #.####   #   #..# # ##     ### #...
...........####### # ####   # ### #..# # ########.# #...
....######.#   #   ####   # ###.# #..###     #....# #...
....#    ###   + ###..# # # #...# ###..# # # #....###...
....#    # +   # #....# #####...#   ###### # ###########
....#    + ##+## #..### #.......###   #### #     #     #
....#    # ## ## #..#   #.........# #   ## # # # #     #
....#    # ## ####..# ###.........### # ## # # # +     #
....###+#####   #...# #.............### ######## #     #
......# #...# # #...# #...............#   #....# #######
......# #...# # #...###...............# # #....# #......
......# #...# # #.....................# # #....###......
......# #...#####.....................### #.............
......# #...............................# #.............
......###...............................###.............
