........................................
........................................
........................................
........................................
........................................
........................................
........................................
...............................#######..
.............................###     ###
.............................#   # #   #
.............................# # # # # #
.............................# # # ### #
.............................# # # #.###
.............................# # ###....
............................####+###....
............................#    # #....
............................#    # ###..
............................#    #   #..
............................#    + # #..
......................#######    # # #..
......................#     +    # ###..
..........#####.......# # # ######+####.
..........#   #.......# # # ###.#     #.
...###..### # #...##### # # # ###     #.
...# ####   # #.###   ### # #   +     #.
...# ##   ###+### + > + ##### # #     #.
...# ## # ##    # #   #   #.# # ###+###.
..##+## # ##    # ##+## # ### #####   #.
..#   # # ##    # ## ####   #+###   # #.
..#   + ####    + ## #..# # #   # # # #.
..#   # #### <  #### #### # #   # # # #.
..######## +    #..#   ## # +   # ### #.
.........# ##+###### # ######   ###.# #.
.........# ##     ####   #..#   + #.###.
.........# ## # # #..### #..###+# #.....
.......### ## # # ###..# ###..# # #.....
...#####   #### #   #..#   #..# # #####.
.###     ###..# ### #### # #### #     #.
.#   # # #....# #.#   ## #   ## # # # #.
.# # # ###....###.# # #### # ## ### # #.
.# # # #..........###   #### ####.# # #.
.# # # #............# # #..###....# # #.
.#######............### #.........#####.
......................###...............
........................................
........................................
