........................................................
........................................................
........................................................
........................................................
........................................................
........................................................
........................................................
........................................................
........................................................
........................................................
........######..........................................
........#    #..........................................
........#  > #..........................................
........#    #..........................................
#########    #..........................................
#      ##    #..........................................
#      ##    #..........................................
#      ####+###...#######...............................
####+###      #.###     #...............................
#      #      ###   # # #...............................
#      #    < +   # # # ########........................
#      +      # # # # ###      #........................
#      ######## ###+#####      ###......................
#+######......# #     # +      + #......................
# #...........###     # #      # ###....................
# #.....#########     + ###+####   #....................
# #...###       +     # #.# #..# # #....................
# #...#   # # # #     # ### #..### #...###..............
# #...# # # # # #+#######   ###### #...# ###............
# #.### ### # # # ####### #     ## ###.#   #............
###.#   #.# ### #   #     # # # ##   ### # #..#####.....
....# ###.###.### # # # # ### # ####   # # #..#   #.....
....# #.#######   # # # # #.###   ## # #+###..# # #.....
##### #.#       ### # # # #...# # ## # #   #### # #.....
#     ### # # # #.# #######...# # ## # +   + ## # #.....
# # # #   # # # #.# #.........### ## # #   # ##+####....
# # ### # # # # #.###...........# #### #+### #   + #####
# # #.# # # ### #...............###..### #.# #   #     #
# # #.# ### #.###......................# #.# +   # # # #
# # #.###.###..........................# #.###   ### # #
#####..................................###...#####.#####
