.............................................
.............................................
.............................................
.............................................
.............................................
.............................................
.............................................
.............................................
.............................................
.............................................
.............................................
.............................................
.............................................
.............................................
.............................................
.............................................
.............................................
.............................................
.............................................
.............................................
.............................................
.............................................
.............................................
.............................................
.............................................
....................#########................
....................#   +   #####............
....................#   # #     #............
..................###   # # # # ###..........
..................# +   ### # #   #..........
..................# ##+#### ### # #####......
............####### ##   ###### #     ###....
............#       ## # #   ## # # #   #....
..........### # # #### # #   #### # # # #....
..........#   # # #..# # +   + #### # # #....
........### # # # #..#####   # #..# ### #....
........#   # ### #...####+### #..###.# #####
........# ### #.###.###      # #......#     #
........# #.###...### +   >  ###......### # #
......### #.....###   #      + #........# # #
......#   #######   # ##+##### ###......### #
....### ###       # # ## #...#   #....##### #
....#   ### # # # ### ## ###.### ###..#   ###
..### ###   # # # #.####   #####   #..# # ###
..#   #.# ### # # #..### #     # # #..# #   #
### # ### #.# # ######   # # # ### #..# ### #
#   # #   #.# ####     # ### #   # ####+### #
# # ### ###.###..# # # ###.### # #   #    # #
# ###.# #........# # # #.....# # # # + <  # #
# #...###........# # ###.....### ### #    # #
###..............#####.........###.##########
