............................................................
............................................................
............................................................
............................................................
............................................................
............................................................
............................................................
............................................................
............................................................
.......................###..................................
.......................# #..................................
.......................# #..................................
.......................# #..................................
.......................# ###....###.........................
...................#####+# #....# #.........................
...................#     # #....# #.........................
...................#     # #....# #.........................
...................#     # #....# #.........................
...................#     # #.####+##........................
...................#     # #.# +   #........................
..................####+###+### #   #........................
..................#      #   # #   ###......................
................###      #   # #   + ###....................
................# +      #   # #   #   #....................
................# ####+###   + #   # # #....................
................# #..#   #   ####### # #....................
..............### ####   +   #.....# # #........#####.......
..............#   ## +   #####....##+#####....###   #.......
..............# # ## #####........#      #....#   # #.......
..............# #### #.....########      #....# # # #######.
..............# #..# #.....#    + + <    ###..# # #       #.
..............# #..###...###    # #      + #..# # # # # # #.
..............###....##### +    # #+###### #..### ### # # #.
.....................#     #    # # ###..# ######+### # ###.
.....................# # # ###+####   ####   #     #### #...
...................### # ###.#   ## #   #### +     + ## #...
...................#   # ##### # ## # #   ## #     # ####...
...................# # # #     # ## ### # ## ###+### ###....
...................# # # # # ### ## #.### ####.# #.#   #....
.................### ##### # #.# ####...# #....# #.# # #....
.................#   #...### #.# #......###....# #.### ###..
.................# # #.....# #.###...........### ###.#   #..
...............### ###.....###...............#     #.# # #..
...............#   #.......................### # # #.### #..
...............# # #.....................###   ### #...# #..
...............# # #.....................#   # #.# #...###..
...............# ###.....................# # # #.# #........
...............# #.......................# # # #.###........
...............###.......................# # ###............
.................................######### ###..............
.................................#     #   #................
.................................#  >  # ###................
.................................#     # #..................
.................................#     + #..................
.................................#     # #..................
.................................#     # #..................
.................................#########..................
............................................................
