....................................................
....................................................
....................................................
....................................................
....................................................
....................................................
....................................................
....................................................
....................................................
....................................................
....................................................
....................................................
....................................................
....................................................
....................................................
....................................................
....................................................
....................................................
....................#####.######....................
................#####   ###    #....................
................#     #   #    #....................
................# # # # # #    #....................
................# # # ### +    #....................
................# ### #.###    #....................
................###.# #...#    #....................
................#####+##########....................
..###...........#      #    ###.....................
..# #...........#      # <  + #.....................
..# ###.###.....#      +    # ###...................
###   ### #.#####      ##+###   #...................
#   # #   #.#   +      ## ### # #...................
# # # # # ### # ####+####   # # ###.................
# # # # # #   # #..#   ## # ###   #.................
# #+##### # # ###..# # ## #   ### #.................
# #    ## # ######## # #### # ### ###...............
###    ##+#### +   # # #### #   #   ###.............
###    +   ### #   # #   #### # ###   #.............
# +    #   + # #   + # # ## ### #.# # #.............
# ######   # ###   ##### ## #.# #.# # ###...........
# #######+## #.#   #...#### #.###.# #   ###.........
####      ######+###......# #.....#####   #.........
.# +      ###      #.....##+####......# # #.###.....
.# #      # +      #.....#   + #......### ### #.....
.# #      + #      #.#####   # #........#   # #.....
.# #      # ######+###   +   # #........### # #.....
.# #      #### +     #   #   # #..........#   #.....
.# ######+##   #     +   #   # #..........#####.....
.###....# ## # # >   #   ##### #....................
........# ## # #     #   #...###....................
........# #### #     #####..........................
........###..#########..............................
