.........................................
.........................................
.........................................
.........................................
.........................................
.........................................
.........................................
.........................................
.........................................
.........................................
.........................................
.........................................
.........................................
.........................................
.........................................
.........................................
.........................................
.........................................
.........................................
.........................................
.........................................
.........................................
.........................................
.........................................
........###..............................
........# ###............................
......###   #............................
....###   # #............................
....#   # # #...#######..................
....# # #+#####.# +   ###................
....# ###     #.# #   + #................
#########     ### #   # #................
#       +  <  #   #+### ###..............
# # # # #     + ### #.#   #..............
# # # # #     # #.# #.### ###............
# ### # #     ###.# #...#   #............
# #.#########+##### ####### ###..........
###.#######    ##         #   #..........
#####   # +    ## ### # # ### ###........
#   +   # #    ## #.# # # ###   #........
# # #   + #    ####.# ###   # # #........
# # #   #####+###...# #.# # # # #####....
# ###   #       ###.###.# # ###     #....
######### # # #   #.####### #.# # # #....
###       # # # # ###     ###.### # ###..
#   # # # ### # #   #   > ###...###   #..
# # # # ###.# # ### +     + ###...### ###
# ##### #...#####.# #     #   #####.#   #
###...# #.........# ####+## #     #.# # #
......###.........# ##   ## # # # #.# # #
..................# ## # #### # # #.### #
..................#### #   #### # #...# #
.....................# # # #..# ###...###
.....................# # # #..###........
.....................### ###.............
.......................###...............
