........................................
........................................
........................................
........................................
......###...............................
....### #######.........................
....#   #     #.........................
....# # #     #.........................
....# # +     #####.....................
....### #     #   #.....................
......# #     # # #.....................
...####+####### # #.....................
...#     #....# # #.....................
.###     #....# ###.....................
.# +     #....# #.......................
.# #     #..###+##......................
.# ###+####.#    ###....................
.# #.#    ###    + #....................
.# #.# >  # #    # ###..................
.# #.#    + +    #   #..................
.###.#    # #    # # #..................
.....###+## #    # # #..................
.....### ##+############................
.....#   #    ###      #................
.....# # #    # +      ###.......###....
.....# ###    + #      + #####...# #....
.....# # +    # #      #     ##### #....
.....### #    ###      # # #     # #....
...##### ######.#####+## # # # # # #....
...#     #..........# ###### # # #+####.
...# # # #.########.# ######## # #    #.
.### # # ###      #.# #     ## # +    #.
.#   # ### +      ### +     #### #    #.
.# #####   #      #   #     #..#####+##.
.# #   # # #      + ######+#####...# #..
.# #   + # #      # ####     + #...# #..
.###   # ###      #### +     # #.### ###
####+#####.#+#######   #     # ###     #
#      #.### ####### # #     #   # ### #
#    < ###   #     # # #     # # # #.# #
#      + # # #     # # #####+### # #.# #
######## # # +     # ###.#   #.### #.# #
.......# #####     # #...# # #...###.# #
.......###...#########...# # #.......###
.........................#####..........
