..............................................
..............................................
..............................................
..............................................
..............................................
..............................................
..............................................
..............................................
..............................................
..............................................
..............................###.............
..............................# #.............
.......#####..........#####...# #.............
.......#   #........###   #...# #.............
.....### # #........#   # #.### #.............
.....# # # #........# # # #.#   #.............
.....# ### #...###..# # # #.# # #.............
.....# #.#+##### #..# # # #.# #+####..........
...###+###     # #..#####+#####    #..........
...#     #     # #.###      # #    #..........
...#     #     + #.# +      + + >  ###........
...#     #     # ### #      # #    + ###......
...#     +     #     ########+###+##   #......
...#     ##+######## #...#     ## ## # #......
...#     ## #.....########     ## ## # ###....
...#####+## #.....# +    #     ## ## #   #....
.....### ## #.....# # <  +     ####### # #....
.....#   ######.### #    #     ###...# # #....
.....# # #..# #.#   #    #     + #...### #....
...### # #..# #.# # #+#######+## #.....# #....
...#   # #..# #.# ### ####### ## #.....# #....
...# # # #..# #.# #   ##      ## ###...###....
...# # ######+##### # ##### # ##   #..........
...# ###..#     ### #   #.# ###### #..........
...# #..###     +   # # #.# ###..# ###........
...###..# +     # # # # ###   #..#   #........
........# ####### #####   ### #..### #####....
......### #.....# #...# # #.# #....#     #....
......#   #.....###...# # #.###....# # # ###..
......# # #...........### #####....### #   #..
......# # #.............#     #......# # # #..
......#####.............### # #......# ### ###
..........................# # #......# #.#   #
..........................# ###......###.### #
..........................###..............# #
...........................................# #
...........................................###
..............................................
