............................................................
............................................................
............................................................
............................................................
............................................................
............................................................
............................................................
............................................................
............................................................
............................................................
............................................................
............................................................
............................................................
............................................................
........................#######.............................
........................# #   #.............................
........................# # < #.............................
........................# +   #.............................
........................# #   #.............................
........................# #####................#######......
......................###+###########..........#     #......
......................#     + ##    ###........#     ###....
......................#     # ##    # #........#     + #....
......................#     # ##    + #........#     # #....
...................######+######    # #........#     # #....
.................### +    #....######+###......####### #....
.................#   #    ########.#    #...........##+###..
.................# # #    +      #.#    #...........#    #..
...............### # #    #      ###    #####.......#    #..
...............#   # #    #      + +    +   #########    #..
.............### # ###+#########+# #    # # #     + + >  #..
.............#   ###    #......# # #    # # #     # #    #..
.............# # #.#    ###..### ###+#### # +     # #    #..
....########.# # #.#    + #..#   ### #..# ###     # ##+###..
....#      #.#######    # #..# #   # ######.#     # ## #....
....#      ####### +    # #### # # #     #..########## #....
..###      +       ###+## ##   ### ### # ###.........# #....
..# +      # # # # ### ## ## # #.# #.# #   #.........###....
..# ######+# # # # #   ## ## # #.# #.# # # #................
..# #....# # # # # # # ########### #.##### #................
..# #....# # # # # # # ###      ####.....# ###..............
..# #..### ### ##### #   +      #........#   #..............
..###..#   #.###     ### #      #........# # #####..........
.......# # #.### # ###.# ########........###     #..........
.......# ###.#   # #...# #.................# # # #..........
.......# #...# # ###...###.................# # # #..........
.......###...# ###.........................# # # #..........
.............###...........................### # #..........
.............................................# ###..........
.............................................###............
............................................................
............................................................
............................................................
