.............................................
.............................................
.............................................
.............................................
.............................................
.............................................
.............................................
.............................................
.............................................
.............................................
.............................................
.............................................
.............................................
.............................................
.............................................
.............................................
.............................................
...............................#########.....
...............................#       #.....
...............................# # # # #.....
.............................### # # # ###...
.............................#   # # ### #...
.............................# # # # #   ###.
..................##########.# # # ### #   #.
..................#      + ### #+##### # # #.
............#######   >  #   ###     ### # #.
........#####     +      # #   #     +   ###.
........#     # # #      # # # +     # ###...
......### # # # # ###+###### # #     #   ###.
......#   # # # ##### ###..# # #####+# #   #.
..##### ####### ###     ###### #...# # # # #.
..#     #.....###   # #   ######.### # # # #.
### # # #.....#   # ### #   ######   # #####.
#   # ###...### # ###.### # ##     ### #.....
# ### #######   ###.....# # ## # # #.###.....
# #.# #       ###.......# # ## # ###.........
# #.### # # # #.........# # #### #...........
# #.### # # # #.........###   ####...........
###.#   # # # #...........###   #.########...
..### # # # ###.............# # ###    + #...
..#   ### ###...............# #   #  < # ###.
### # #.###.................### # #    #   #.
#   ###.......................### +    # # #.
# # #...........................# #    # # #.
# ###...........................###    # # #.
###...............................##########.
