..............................................
..............................................
..............................................
..............................................
..............................................
..............................................
..............................................
..............................................
..............................................
..............................................
..............................................
..............................................
..............................................
..............................................
..............................................
..............................................
..............................................
..............................................
..............................................
..............................................
..............................................
..............................................
...................................###........
...................................# #........
...................................# #........
...................................# #........
...................................# #........
...................................# #........
.................................###+#####....
............#####...#########..###     + #....
........#####   #...#     + #..# +     # #....
......###     # #...#     # #..# #     # #....
......#   # # # #...#     # #..# # <   # #....
......# # # ### #...#     # #..# #     # #....
......# # # #.# #.####+#### #..# #     # #....
......#######.# ###      ## #..#####+#####....
....###########+# +      ####....#      #.....
..###       +   # #      #########+######.....
###   # # # #   # #      +   #      + #.......
#   # # # # #   + #      # # +      # #.......
# # # # # # #   # #      # # #      # #.......
# ###########   ####+##### # #+###### #.......
# #.........######     + # # #   #..# #.......
# #..............#     # ### # # #..# #.......
###....###########     #   ### # #..###.......
.......#         +     # # #.# # #............
.......# # # # # #     # # ### # #............
.......# # # # # ##+######   ######...........
.......# ### ###### #....### #    #...........
.....### #.# ###### ######## #    #.######....
...###   #.####     #      # +    ###    ###..
.###   ###..### # # #      ###    + #    + #..
.#   # #....#   # # +  >   ######## +    # #..
.# # # #....# # #####      + ###..# #    # #..
.# # # #....# # #...#      #   #..# #    # #..
.# # # #....# # #...######## # #..# ###### #..
.### ###....# ###..........### #..# #....###..
...###......###..............###..###.........
