............................................................
............................................................
............................................................
............................................................
............................................................
............................................................
............................................................
............................................................
............................................................
............................................................
.........................###................................
.........................# #................................
.......................### #................................
.......................#   #................................
......#######..........# # #................................
......#     #..........# # #................................
......# # # #..........### #................................
......# # # #.........####+####.............................
......# # #+###.......# #     #.............................
......# # #   #.......# #     #.............................
......# ###   ###.....# +     #.............................
......### +   + #.....# #     #.............................
....###   #   # #...### #######.............................
....#   # #   # #...#   #..######...........................
....# # #######+##### #+####    ###.........................
....# #####.###   #   #    #    + ###.......................
....###.# #.# +   # ###    #    #   #.......................
........# #.# #   + #.#    +    # # #.......................
........# #.# #   # #.#    ##+##### #...###.................
........# #.# ##### #.######   + ## #...# #.................
........# #.############.# + > # ## ###.# #.................
......###+##### +      ### #   # ##   #.# #.................
....### +     # #      #   ##+####### #.# #.................
#####   #     + #      + # ## ###...# ### ###...............
#   # # #     ###      # ####   #...#       #...............
#   + ######+##############   # ###.# # ### #...............
#   # #....# #.# +      #   ###   #.# # #.# #...............
##### #....# ### #  <   # # #.# # #.### #.###...............
....# #....# #   #      + # #.### #######...................
....###....### ###      ### #...#     #.....................
.............# ####+#####.###...### # #.....................
.............# ##   #####.........# # #.....................
.............# ## #     #.........# ###.....................
.............#### # # # #.........# #.......................
................# # # # #.........# #.......................
................### # ###.........###.......................
..................#####.....................................
