.........................................
.........................................
.........................................
.........................................
..............................######.....
..............................#    #.....
............................###    #.....
............................# +    #.....
............................# #    #.....
............................# ######.....
............................# #..........
............................#+####.......
..........................###    #.......
..........................# +    #.......
..........................# #    #.......
..........................# #    #.......
..........................###    ###.....
............................#    + #.....
..........................#####+## #.....
..........................# +   ## #.....
..........................# #   ## #.....
..........................# #   ## #.....
..........................####+#######...
............................#      + #...
........................##### <    # ###.
......................###   +      #   #.
......................#   # #      # # #.
......................# # # ####+### # #.
.................###### # # #..# ##### #.
.................#    ###+######   #.# #.
...............###    #      + # # ### #.
...............# +    #      # ###   ###.
.............### #    +      #   # # #...
......######.#   ##+###      # # ### #...
......#    #.# #### #.#      # # #.###...
......#    ### ##   ###+###### # ###.....
....###  > +   ## # #    + #.###   #.....
....# +    # # ## # #    # #.##### #.....
....# ###### #### # #    # #.#   # #.....
....# #....# #..# ###    ###.# # # #.....
....# #....# #..#######+###### # # #.....
....# #....# #...# +      + ####+######..
....# ##########.# #      # #     +   ###
....### +      #.# #      # #     # #   #
......# #      #.###+###### +     # # # #
......# #      ###     ######     ### # #
......# #      + +     #   ####+###.### #
....### #      # #     #   ##    #....# #
....#   #      # #     #   ##    ###### #
....# ######+### #     +   ##    +   ####
....# #..#     ###     #   ##    # # #...
....# #..#     #.###+###   ##    # # #...
....###..#     #...# #.########### # #...
.........#     #...# #...........### #...
.........#######...# #.............###...
...................###...................
