..................................................
.............###..................................
...........### #..................................
...........#   #..................................
...........# # #..................................
...........# # #..................................
...........# # #..................................
.........#####+#..................................
.........# +   ###................................
.........# #   + ###..............................
.......### #   #   #..............................
.......#   ##+## # #..............................
.......# ###   # # #..............................
.......# # +   # # #..............................
.......# # #   ### #..............................
.......# # #   + # #..............................
.......######+## ###..............................
......###.#    # #................................
......# #.#    # #................................
......# #.#    ###................................
......# #.#    #..................................
......# #.#    #..................................
....###+#####+###....########......#####..........
....#    # #    #..###      ###....#   #..........
....#    # +    #..# +      + #....# # #..........
..###    + #    #..# #      # #....# # #..........
..# +    # ######### #      # ###..# ###..........
..# ######+#####     #      #   #..# #............
### ##   +   #   # ####+####### ####+###..........
#   ## # #   # # # #..# ###...#   #    #..........
# #### # #   # # # #..#   #...# # #    #..........
# ## # ###   + # # #### # ###.# # #    #..........
# ## # #.# > # # ####   #   #.### +    #..........
#### # #.#   ######   ### # #...# #    ###........
####+#######+###### # #.# # ###.# #    + #........
# +      #     ##   # #.# #   ######+### ###......
# #      #     ## # ###.### # ##       #   #......
# # <    +     ## # #.....# # ## # # # ### ###....
###      #     #### #.....### ## # # # #.#   ###..
..#      #######..###.......# ###### ###.# #   #..
..########..................###....###...# # # #..
.........................................# ### #..
.........................................###.###..
..................................................
