................................................
................................................
................................................
................................................
................................................
................................................
................................................
................................................
................................................
................................................
................................................
................................................
................................................
..........................................###...
........................................### #...
........................................#   #...
........................................# # #...
........................................# # #...
........................................### #...
.....................................######+#...
...................................###      #...
...................................# #      ###.
...................................# +      + #.
...................................# #      # #.
................................####+######## #.
................................#    + ###..# #.
................#####.........###    #   #..###.
................#   #.#####...# +    # # #......
................# # #.#   ###.# #    # # ###....
................# # #.#   + #.# #    ###   #....
..............#####+###   # #.# #+###### # #....
..............#     # +   # ###+# #   #### #....
..............#     # ###+###   # +   #..# #....
..........#####     # #     #   # #   #..# #....
........###   +     + # # # +   ########.###....
........#   # #     # # # # #   #      #........
........# # # #     ### # ###   +    > #........
........# ######+####.# ###.#+###      #........
........###....# ###### #####   ####+###........
...............# #   ####   # # #### #..........
.............### #   ## +   # # ##   ###........
...........###   +   ## #   + # ## #   #........
...........#   ###   ## # < ### ## # # #........
...........# # #.#   ## #   #.# ## ### #........
...........# # #.##+### ##+##.######.# #........
.........### ###..# #.# ## #####.....###........
.........#   #..### ######     #................
.........# ###..#     #..# # # #................
.........# #....# ### #### # # #................
.....##### #....# #.#   ## ### #####............
.....#     ###### #.# # ####.#     #............
.....# # ###    # #.### #....# # # #............
.....# # #.#    + #...# #....### # #............
.....### #.#    ###...###......### #............
.......###.######................###............
