...............................................
...............................................
...............................................
...............................................
...............................................
...............................................
...............................................
...........................########............
...........................#    + #............
...........................#    # #............
...........................#    # #............
...###.....................#    ###............
...# #.............######..#    #..............
...# #.#####.......#    ######+##..............
...# #.#   #.......#    + #    #...............
..##+### # #.......#    # +    #...............
..#    # # #......####### #    #####.#####.....
..#    #+###......#   ###+######   #.#   #.....
..#    +   ###....# # #      ### # #.# # #.....
..#    #   # #....# # #      + # # #.# # #.....
..#+####   + #.####+# +      # ###+### # #.....
..# ####   # #.#    ###      # #     ###+###...
###   ##   # ###    ######+### # >   #   + ###.
#   # ###### # +    +    # #.# #     #   #   #.
# # #   #..#   #    #    # ### +     +   # # #.
# # ### #..### ##+###  < #   ###     #   ### #.
### #.# ###..# ## #.#    ### #.#     #   #.# #.
..###.#   #..# ## #.#    #.# #.#####+#####.###.
......# # #..#### #.#+####.###...### #.........
......# # #.....# #.#   #####....#   #####.....
......### #.....##### #     ###..# #     #.....
........###.......#   # # #   #### ### # ###...
..................# # # # # # ##   #.# #   #...
..........######### # ### # # ## # #.# # # #...
..........#         # #.### # ## ###.# # # #...
..........# # # # # ###...# # ## #...##### #...
..........# # # # ###.....### ####.......# #...
..........# # # ###.........###..........# #...
..........### # #........................###...
............#####..............................
...............................................
...............................................
...............................................
...............................................
...............................................
