............................................
............................................
............................................
............................................
............................................
............................................
............................................
............................................
............................................
............................................
............................................
............................................
............................................
............................................
............................................
............................................
............................................
............................................
............................................
............................................
............................................
............................................
............................................
............................................
................###.........................
................# #.........................
................# #.........................
.......#####..### ###.......................
.....###   ####     #.......................
.#####   #   ## # # #.......................
.#   # # # # ## # # ###########.............
.# # # # # # ####+###   +     #.............
.# # # # # ###    # + > # # # #.............
.# # # # #   +    # #   # # # #####.........
##+### ### ###    + ##+## ###     ###.......
#    ###   #.#    #### ## #.# # #   #.......
#    #   # #.#    ##   ######## # # #.......
#    # # # ######### # #   #..### # #######.
#    + ###   ##    # # #   #....# #       #.
#    # #.### ##    + # +   #....### # # # #.
#    # #...# ##    # ### < #......# # # # #.
####+###...#######+# #.#   #......### # # #.
.#     ########..# #######+#####....### ###.
.# # # #      #### ### +     + ###....###...
.# # # #      ##     # #     #   #####......
.# ### +      ## ### # #     # #     #......
.# #.###      ## #.# # ###+### # # # #......
.# #...#      ####.# ##### #.# # # # #......
.###...#####+##....#     # #.##### # #......
...........# #.....### # # #.....#####......
...........# #.......# # # #................
...........# #.......# # # #................
...........# #######.# # ###................
...........# #     #######..................
...........# +     + #......................
...........###     # #......................
.............####### #......................
...................# #......................
...................# #......................
...................###......................
