........................................................
........................................................
........................................................
........................................................
........................................................
........................................................
........................................................
........................................................
........................................................
........................................................
........................................................
........................................................
........................................................
........................................................
........................................................
........................................................
........................................................
........................................................
........................................................
........................................................
........................................................
........................................................
........................................................
........................................................
........................................................
.....................................#####..............
.......###.........................###   #..............
.......# #.........................#   # ######.........
.......# #.............#########...# # #   ## #.........
.......# #.............# +     ###.# # ### ## #.........
......##+#####.........# #     + ### # #.# ## #.........
......#      #.......### #     #   ###+######+###.......
......#      ###...###   #     # # #     #    + #.......
......#      + #...#   ####+#### # #     +    # #.......
......# >    # #...# # #..# #..# # #     #    # #.......
......#      # #.### # #### #### # +     ###+## #.......
......######## #.#   # ##     #### #     #.# ####.......
....##########+### ###### ### #..###     #.#   #........
..### ##     #   # #..#   #.# #....####+#### # #........
..#   ##   < +   + #..# # #.# #####.#     ## # ###......
..# # ##     #   # #### ###.#     ### # # ## #   #......
..# #+####+##########   #...# # #   # # # ###### #......
..# #    # ########   # #...### # # # # #     ## ###....
..# #    +   ##   # # ###.....# ### ####### # ##   ###..
..###    # # ##   + ###.......###.#   #...# # ## #   #..
....######## ##   # #.............# # ###.# # ## # # #..
...........######+####............###   #.########## #..
..............#    + #..............### #..........# #..
..............#    # #................# #..........###..
............###    # #................# #...............
............# +    # #................###...............
............# #    # #..................................
............# ########..................................
............# #.........................................
............# #.........................................
............###.........................................
