.......................................................
.......................................................
.......................................................
.......................................................
.......................................................
.......................................................
.......................................................
.......................................................
.......................................................
.......................................................
......###..............................................
......# #..............................................
......# #..............................................
......# #..............................................
......# #..............................................
......# #..............................................
......# #..............................................
....###+######.........................................
....#    # # ###.......................................
..###    # #   #.......................................
..# +    + # # #.......................................
..# #    # # # #.......................................
..# ###### # ###.......................................
..# #.#      ######....................................
..# #.######+##   ###..................................
..###..###    # #   #..##########......................
.......# +    # # # #..#      + #......................
.......# #    # # # ####   <  # ###....................
.......# #    + # #### +      #   ###..................
...##### #    ###+#### ####+### #   #..................
...#     #    # +    # #..# #.# # # #..................
.### # # ###### #    + #### #.# # # ###................
.#   # ###....# #    ####   #######   #................
.# # # #....### #+####..# #       # # #................
.# # ###....#   # #.....# ### # # # # ###..............
.# ###....### # # ###.### #.# # # ###   ###............
.# #......#   ###   #.#   #.# ### #.# #   #............
.###....### # #.### #.# ###.###.###.### # #............
........#   # #...# #.# #.............### #######......
......### # # #...# #.# #...............#       #......
....###   #####...##### #...............### # # #......
..###   # #.........#   #.................# # # #......
..#   # ###...#####.# ###.................# ### #......
### # # #...###   ### #...................# #.# #####..
#   # # #...# + > +   #...................# #.#     #..
# ### # #...# #   # ###...................###.### # #..
# #.# ###...# ##### #...........................# # ###
###.###.....# #...###...........................###   #
............# #...................................# # #
............# #...................................# # #
............###...................................#####
