.....................................................
.....................................................
.....................................................
.....................................................
.....................................................
.....................................................
.....................................................
.....................................................
.......###...........................................
.......# #...........................................
.......# #...........................................
.......# ####........................................
.......# ## ###...........................###........
......##+##   #...........................# #........
....###   # # ###.......................### #........
....# +   + #   #.......................#   #........
....# #   # ### ###.....................# # #........
..### ##### #.# # #............###......# #+#####....
..#   #..##+##### ###..........# #......# #   # #....
..# ###..#      #   #........### #......# #   # #....
..# #..### >    # # #........#   #......# #   + #....
..###..# +      + # #........# #+####...###   # #....
.......# #      # # ########## #    #.....#   # #....
.....### ##+#####+# # +      ### <  ###...#####+##...
.....#   ## #.#   ### #      + +    + ###.#      #...
.##### # ## #.#   #   #      # #    #   #.#      #...
.#     #### #.#   # ######+### #    # # ###      #...
.# # # #..# #.#   + ###### #.# ########   +      #...
.# # ###..#####   # ##     #########..# # #      ###.
.# # #....### +   # ## # #         #### # #      + #.
.# # #....#   ###+# ## # ### # # #   #### #####+## #.
.# # #....# # ### ###### #.# # # # # #..# #.#   ## #.
.#####....# # #   ###..# #.# # # ### #..# #.# # ## #.
..........# # # #   #..###.### # #.# #..##### # ####.
..........# ### # # #........#####.# #....#   # #....
..........# #   ### #..............###....# #####....
..........### ###.# #.....................# #........
............# #...# ###...................# #........
............# #...#   #...................# #........
............###...### #...................###........
....................# #..............................
....................# #..............................
....................###..............................
.....................................................
.....................................................
