........................................................
........................................................
........................................................
........................................................
........................................................
........................................................
........................................................
........................................................
........................................................
........................................................
........................................................
........................................................
........................................................
........................................................
........................................................
........................................................
........................................................
.........###............................................
.......### #............................................
.......#   #............................................
.......# # #............................................
.......# #+######.......................................
.......# #      #.......................................
.......###      #.......................................
.........#      #.......................................
.........####+######....................................
..........# +    + #....................................
..........# #    # #.....######.........................
..........# #    # #...###    #.........................
..........#####+## #...# +    ###.......................
.........###    ## #.### #    + ###.....................
.........# + >  ## #.#   #    #   #####.................
.........# #    ###### ###+#### #     ###...............
.........# #    ####   ### #..# # # #   #...............
.........#####+###   # #   #### # # # # #...............
.............#   # # ### #   #### # ### #...............
.............#   + ###   # #   ######.# #...............
...........###   ###   ### # #   ###### #...............
...........# #####   # #.##### #     ## ######..........
...........# ##### # # #.....### # # #####   #..........
...........# #     # # #.......### # #...# # #..........
.......#####+# # # # # #.........# # ###.# # #..........
.....###     # # # # ###.........###   #####+#####......
.....# +     + ### ###.............# #   #.#     #......
.....# #     # #.###...............### # ###     #......
...### #####+# #.....................###   # <   ###....
...#   #...# ###.......................# # +     + #....
...# # #...# #.........................### #     # #####
.### ###...# #...........................# #     #     #
.#   #.....# ###.........................###+##### # # #
.# # #.....#   #.........................#     #.# # # #
.# # #.....# # #.........................# # # #.# ### #
.#####.....### #.........................# # # #.###.###
.............###.........................#######........
