...........................................
...........................................
...........................................
...........................................
...........................................
...........................................
...........................................
...........................................
...........................................
...........................................
...........................................
...........................................
...........................................
...........................................
........#####..............................
......###   #####..........................
......# +   +   #..........................
......# #   # # #..........................
......# #   # # #..........................
......# ##+#### #..........................
......###   #.# #..........................
......###   #.# #..........................
......# # < #.###..........................
....### +   #..............................
....#   #   #....########.......#####......
..### # #   #..###      #.......#   ###....
..#   #+#####..# +      #.......#   # #....
..# # #   ###..# #      ###.....#   + #....
..# # #   + #### #      + #.....#   # #....
..# # #   # ##   ####+### #.....##### #....
..#####   # ## ####     # #....###### #....
....####+##### #..# # # # #....#   ##+####.
##### +   #..# #..# # # # ###### # #     #.
#     #   #..# #### ### #     ## # +     #.
# # # #   #..# ##   #.##### # ####+#     #.
# # ###   #..#### ###.....# # #    ###+####
# ###.##+######## ######..# # #    + #    #
###....#    #   # ##   #..# # +    # ######
.......#    # > # ## # #..# ###    #   ###.
########    +   + ## # #..###.#    ###   #.
# +    #    #   ###### #....#####+#### # #.
# #    ########+###..# ###### +    + # # #.
# #    #.# +      #..# ##     #    # ### #.
# ###+#### #      ####+## # # #    #   ###.
####     # #      #    ## # ###    # # #...
...#     + #      +    ## # #.###### # #...
...#     # ########    #### #......### #...
...#########......######..###........###...
