.......................................................
.......................................................
.......................................................
.......................................................
.......................................................
.......................................................
.......................................................
.......................................................
.......................................................
.......................................................
.......................................................
.......................................................
.......................................................
.......................................................
.......................................................
.......................................................
.......................................................
.......................................................
.......................................................
.......................................................
.......................................................
.......................................................
.......................................................
.......................................................
.......................................................
.......................................................
.......................................................
.......................................................
.......................................................
.#######...............................................
.#     #.................#######.......................
.#  >  #.................#   + #####...................
.#     #.................#   #     #...................
.#     #.................#   # # # #####...............
.###+#####...............#   # # #     #...............
...#     #####.........###   # # ### # #...............
...#     #   #.........# +   ### #.# # #...............
...#   < + # #.....##### ##+##.##### # ###.............
...#     # # #.....#     ## #...# ## # # #.............
...#+#####+###.....# # #### ##### ## ### #.............
...# #.#   # #...### # ##       # ####.# #.............
...# #.#   # #.###   #### ### # # ######+##............
...# #.#   + #.#   # ##   #.# #     #     #............
...# #.#   # ### # # ## # #.### ### #     #............
...#########+#   ###### ###...# #.# +     ###..........
......#      # # #....###.....# #.# #     + ###........
..#####      + ###............###.# #+#####   #####....
..#   +      # #..................# # ###.# #     #....
### # #####+## #..................###   ### # # # #....
#   # #.#   ####....................# #   ##### # #....
# ### ### # #.......................# # # ###.# ######.
# #.###   # #...#####...............# ###   #####    #.
###.#   # # #####   #...............###.# #   ###    #.
....# # # #     #   #...................### #   +    #.
....# ### # # # #   #.....................# # # #    #.
....###.##### # +   #.....................# # # #    #.
............# # #   #.....................##### ######.
............### #   #.........................# #......
..............# #####.........................###......
..............###......................................
