..........................................
..........................................
..........................................
..........................................
..........................................
..........................................
..........................................
..........................................
..........................................
..........................................
..........................................
...............#######.#####..............
...............#     ###   #..............
...............# # # #   # ###............
...............# # # # # #   #............
...............# # # # # # # #............
...............### ### # ### #............
...........#######+##### ######...........
...........#   +      ##+##   #...........
.........### # #      +   # # #...........
.........#   # #      # > # # #...........
.........# # ##########   ### #...........
.........# # #.......###+#### #...........
.........# # #.......#      #+####........
.........# ###.#######      #    #........
.........###...#   # +      #    ###......
...............#   # #      +    + #####..
...............#   + #      #    #     ###
...............#   ###      ####+# # #   #
............#############+###..# # # # # #
............#     +    #   ##### # ##### #
............# # # #    #   +   # # #...# #
............# # # #    +   # # #####...# #
........##### # # ###+##   # #   ###...###
........#     # ###.# ##   #####   ###....
........# # #####...# ######...# #   #....
........# # #.......# #........### # #....
........#####.......# ###........# # #....
..............#######   ###......# # #....
............###       #   #......### #....
.....########   # # ### # ###......# #....
.....#      # # # # #.# #   #......###....
.....#      # # # # #.##### #.............
.....#      + ### # #.....# #.............
.....#      # #.#####.....# ###...........
....##+########...........#   ###.........
....#   #.................###   #.........
....#   #...................# # ###.......
....# < #...................# #   #.......
....#   #...................##### ###.....
....#   ###.....................#   #.....
....#   + #.....................# # #.....
....##### #.....................# # #.....
........# #.....................### #.....
........# #.......................# #.....
........# #.......................# #.....
........# #.......................###.....
........###...............................
