.............................................
.............................................
.............................................
.............................................
.............................................
.............................................
.............................................
.............................................
.............................................
.............................................
.............................................
.............................................
...........###...............................
...........# ###.....#####...................
.........###   #...###   #...................
.........#   # ###.#   # ###.................
.....##### # #   #.# # #   #.................
.....#   # # # # #.# # # # #.................
.....# # ###+### #####+### #.................
.....# # ##    ####      #####...............
.....# # ##  > ## +      #   #...............
.....### ##    ## #      + # #...............
.......# ##    ## #      # # #...............
.....###+##    ## #      # # #...............
.....#   ##    ## ######## ###...............
.....#   ####+######     #+######............
...###   + +     #.#     #      #............
...# +   # #     ###     #      #............
...# ###+# #     # +     #      #............
.### #.# ###     + #  <  +      #............
.#   #.# # #     # #     #      ###..........
.# # ### # #     # ####+##      + #..........
.# # #   # ###+#####..# ###+##### #####......
.# ### # # #.#   ###### ###     #     ###....
.##### # # #.# #   ##     # # # # # #   #....
...#   ###+### # # ## ### # # # # # # # #....
...# # ###   # # # ## #.# # # ### # # # #....
...# # # +   + # #### #.# # ###.### # # #....
...##### #   # # ##   #.# ###.....##### #....
.....### #+######## ###.###...........###....
.....#   # #....#   #........................
.....# # # #..### ###........................
...### ### ####   #..........................
...#   #.# ##   # #..........................
.### ###.# ## # ###..........................
.#   #...#### # #............................
.# ###......### #............................
.# #..........# #............................
.###..........###............................
