........................................................
........................................................
........................................................
........................................................
........................................................
........................................................
........................................................
........................................................
........................................................
........................................................
........................................................
........................................................
........................................................
........................................................
........................................................
........................................................
........................................................
........................................................
........................................................
........................................................
........................................................
........................................................
.....###########........................................
.....#     #   #........................................
.....#     # # #........................................
.....#     + # #........................................
.....#     # # #........................................
.....#     # # #..........#####.........................
.....#########+###........#   #.........................
........###      #........#   #.........................
........# +      ##########   ###.......................
........# #      #     ## +   + #...........#####.......
......### #      + # # ## # < # #...........#   #.......
......#   #      # # # ## #   # ###.........# # #.......
....### # #      ### # #####+##   ###.......# # #.......
....#   # ########.# # #.### ####   ###.....# # #.......
....# # ###........### ###     ## #   #.....### #.......
....# ###......#######+#   # # ## # # #....#### ##......
....# #......###   +   # # # # ## # # ###..#     #......
....# #......#   # # > + ### # #### #   ####+#####......
....# #......# # # #   # #.# ###..### # #     #.........
....###....### # #####+# #.###......### #     #####.....
...........#   # #...# # #.######.....# +     +   #.....
.........### #####...# ###.#    #.....# #     # # #.....
.......###   #.......# #####    ###...###     # # #.....
.......#   ###.....###     #    + #####.###+#######.....
.......# # #...#####   # # +    #     #...# #...........
.......# ###...#     # # # #    # # # #...# ##########..
.......# #.....# # # ### # #    # # # #...#   #    + #..
.......# #.....# # # #.# # ####+# # # #...# # #    # ###
.......###.....# #####.# # #..# ##### #...### +    #   #
...............###.....#####..# #...###.....###    ### #
..............................# #.............#    #.# #
..............................###.............######.###
