.......................................................
.......................................................
...........................######......................
...........................#    #......................
...........................#    #......................
...........................#    #......................
...........................#    #......................
...........................#    #......................
...........................###+###.....................
..........###..............# +   #.....................
..........# #..............# #   #.....................
..........# #..............# #   #.....................
..........# #.......###....# #   #.....................
..........# #.......# #....# #   #.....................
..........# #.......# ###..###   #.....................
..........# #...#####   ###.###+###....................
........###+#...#     #   ###     #....................
........#   #.### # # # #   #     ########.............
........#   #.#   # # ### # +   < #    + #.............
........#   ### # ###+### # #     +    # #.............
........#   +   # ##    ### #######    # #.............
........#   # # ####    #.# #.....###+####.............
........#   # ######    #######....#   #...............
.....##########..# +    +     #....#   #...............
.....#   # #...### #    #     #....#   #...............
.....# # # #...#   #    #     ###..#####...............
.....# # # #.### ######+#     + ###...#######..........
.....# #   ###   #....# #     #   ###.#     #..........
.....# ### #   # #..### #     # #   #.#     #..........
.....#####+# # ###..#   #####+# # # ###     #..........
......#    # # #..### #   ### ### #   +     #..........
....###  > + # #..#   ### #   ### ### #     #..........
..### +    ### #..# # #.# # #   ###.# #     #..........
..#   ####+######## # #.### # #   #.# #######..........
..# # #..#   #..#   #####   ### # #.# #................
..# # #..# # #..# # #.#   # #.# # #.# #................
..# ###..# # #..# # #.# # # #.# # #.###................
..# #....# # #..# ##### # ###.### #....................
..###....### ########   # #.....###....................
...........#   #..#   # # #............................
...........### #..# # #####............................
.............# #..# ###................................
.............###..# #..................................
..................###..................................
