.............................................
.............................................
.............................................
.............................................
.............................................
.............................................
.............................................
.............................................
.............................................
.............................................
.............................................
.............................................
.............................................
.............................................
.............................................
.............................................
.............................................
................................###..........
................................# #..........
................................# #..........
................................# #..........
................................# #..........
................................# #..........
................................# #..........
..........................#######+##.........
..........................# #      #.........
..........................# #      #.........
..........................# #      #####.....
..........................# +      +   #.....
..................#########+#    < # # #.....
..................# +   #   #      # # #.....
..............##### #   +   ######## # #.....
..............#     #   #   +   #..# # #.....
............### # # #   ###+# # #### # #.....
............#   # # #   #.# # #   ######.....
............# # # ###   #.# #####   #........
........##### # # #.###+#.#   #.# # #........
......###     #######   #.# # #.### #........
....###   # ###...#   # ##### #...# #........
....#   # # #..#### # #   #####...# #........
....# # # # #..# ## # # # #   #...###........
..### # # # #..# ## ### # #   ##########.....
..#   # #####..# ## #.### #   #      + ###...
..# #####......# ## #...# +   +      #   ###.
..# #......##### ##########   #      # #   #.
..# #......#     #...# #..#   ###+#### # # #.
..###......# # #+##### #..#+###.# #..##### #.
..########.# # #    ## #..#   ### #......# #.
..#      ### # #    ##+#### #   # #......# #.
..#      #   # #    +   #   # # # ###....# #.
..#      + # ###    #   # # ### #   #....###.
..#      # ###.#    # > + ###.# # # #........
..#+###### #...#+####   # #...# ### ###......
..# #....# #...#   ##   # #...# #.#   ###....
..# #....###...# # ###### #...###.# #   #....
..# #..........# # #....###.......# # # #....
..###..........# ###..............##### #....
...............###....................###....
