.........................................................
...###...................................................
...# #...................................................
...# #...................................................
...# #...................................................
..##+#####..................###.###......................
..#      #..................# #.# #......................
###      #..................# #.# #......................
# #      #..................# #.# #......................
# +      #.###..............# #.# #......................
# #      #.# ###............# #.# #......................
# #      #.#   #............# ###+##.....................
# ########.# # #........#####+#    #.....................
# #........# # #........#     +    #.....................
#+##########+# #......###     #    #.....................
#     #      # ######.# +     ###+##.....................
#     #      # ##   #.# #     #.# #......................
#     +      #### # #.# #######.# #......................
#     #      #..# # ###+##......# #......................
#     #      #..# # #    #......###......................
##########+###..# # #    #######.........................
...#   +    #####+###    +     ###.......................
...# # #    # #    ##    #     + #.....#####.............
.### # #    # +    ##+####     # #.....#   #.............
.#   # #    + #    ## #..####+## #.....# # #.............
.# # # #    # ####### ###.#   ## #####.# # #.....###.....
.# #####    # #...#     #.# # ##     ### # #.....# #.....
.###.###+####+##### # # ### # ## # #   # # #.....# #.....
.....#   # +      # # # #   ###### # # ###+#####.# #.....
...### # # #      # ### # ###....# # #   #     ###+###...
.###   # # #      # #.# # #......### # # +  >  #     #...
.#   # # # #      + #.### #........# ### #     +  <  #...
.# # # # ###      ###...###........###.# #####+#     #...
.# # # ###.#      #....................###.#   #######...
.### ###...##+#####........................# #   #.......
...# #......# ###..........................# # # #.......
...###......#   #..........................# # # #.......
............# # #..........................# # ###.......
............### #..........................# # #.........
..............###..........................#####.........
