...........................................................
...........................................................
...........................................................
...........................................................
...........................................................
...........................................................
...........................................................
...........................................................
...........................................................
...........................................................
...........................................................
...........................................................
...........................................................
...........................................................
...........................................................
............................###............................
............................# #............................
..........................### #............................
..........................#   #............................
..........................# # #.###..........#####.........
..........................# # ### #..........#   #####.....
.......................######+#   #........### #     #.....
...................#####      # # #........#   # # # #.....
...................#   +      # # #........# ### # # #.....
................#### # #  <   + # #........# ###+### #.....
................# ## # #      ###+#######..# #   + ###.....
................# ## ##########.#     + #..# #   #   #.....
..............### ## #....#######     # #..###   # # #.....
..............#   ####..###     +     # #######+## # #.....
..............# # #.....# +     #     #   #     ## # #.....
..............# #+#####.# #     ####### # #     ######.....
..............# #     ### #####+#.....# # #     #..........
..............# #  >  # # #...# #.....### +     ###........
..............###     + # #...# #.......# #     + #........
................#     # ###...# #######.###     # #........
................#######+#######       #...####### #........
..................### +     #   # # # #######...###........
..................#   #     # ### # #       #..............
..................# # #     + #.# ##### # # #..............
............####### # #     # #.# #...# # # #..............
............#       ####+######.# #...# ### #..............
............# # # ####   #......###...###.###..............
......####### # # ##   # #####.............................
......#     # ### ## # #     ###...........................
......#     + #.# ## ### # #   ###.........................
......#     # #.# ####.### # #   #.........................
......##+######.###......# ### # #.........................
.......# #...............# #.### #.........................
.......# ###.............# #...###.........................
.......#   #.............###...............................
.......# # #...............................................
.......# # #...............................................
.......# # #...............................................
.......#####...............................................
...........................................................
