.........................................
.........................................
.........................................
.........................................
.........................................
.........................................
.........................................
.........................................
.........................................
.........................................
.........................................
.........................................
.........................................
.........................................
.........................................
.........................................
.........................................
.........................................
.........................................
.........................................
.........................................
...................................#####.
...................................#   #.
...................................# # #.
...................................# # #.
...............................###.# # #.
..###........................### #.### #.
..# #......................### # #...# #.
..# ###..........#######...#   # #####+##
..#   #..........#     ###.# # #   #    #
..# # #......#####     + #.# #   # + <  #
..# # #......#   +     # #.###+### #    #
..# # #....### # ###+### ###.#   # ####+#
###+####...#   # ### #.#   #.#   ###..# #
#      ##### ### #   #.# # ###   + #### #
#      #     #.# # # #.###   +   #   ## #
#      + # ###.### # ###.# # #   # # ####
#      # # #.###   #   #.# # #   ### ###.
#      # ###.#   ##### #########+#.#   #.
##+#######...# # #...#     ###   #.### #.
.#   #.......# # #...### #   # # #...# #.
.# # #.......# # #.....# # # # # ###.# #.
.# # #.....### ###.....# # # # #   #.# #.
.# # ###...#   #.......####### # # ### #.
.# # # #.### ###.............# ###   ###.
.# # # #.#   #...............###.# # #...
.##### #.# # #...................# # #...
...###+### # #...................# # ###.
.### +   # # #...................###   #.
.#   # > + #######.................### #.
.# # #   ###     #...................# #.
.# # #+#####     ###.................###.
.# # #     +     + #.....................
.### # # # #     # #.....................
...### # # #     # #.....................
.....###############.....................
