....................................................
....................................................
##############..###.................................
#     +      #..# #.................................
# # # #      #..# #.................................
# # # #      #..# ###...............................
# ### #      #..#   #...............................
# #.# #      #..# # #...............................
###.# #      #..# # #...............................
....######+######+# #...............................
....# +    #      ###...............................
....# #    #      #.................................
..### #    +      #.................................
..#   #    #      #.................................
..# # ######      #.#####...........................
..# ###   #####+#####   #...........................
..### +   #..#     ## # ###.........................
###   #   ####     ## #   #.........................
#   # #   ## +     ## # # #.........................
# # ###   ## #     #### # ###.......................
# # #.#   ## ##########+#   #.......................
# # ####+### #....#     ### #.......................
### ##     #+######     #.# #.......................
..####     #      #     #########...................
...# #     +      # >   +   +   ###.................
...# #     #      +     #   # #   #.................
...# #     #      #     #   # # # #.................
..##+##+####+#######+####   # # # ###...............
###   # #..# #####   #..#+### ###   #...............
# +   # #### #   # # #..# #.# #.# # #...............
# # < + ##   #   # # #### #.###.### #...............
# #   # ## # +   # ####   #.......# ###.............
# ###+#### ###   ###..# # ###.....#   #.............
# #.# #### #.#   #....# #   #.....### #.............
###.#   ####.#+###....# ### #.......# #.............
....# # #....# #....### #.# #.......# ###...........
....### #..### ######   #.# #.......#   #...........
......# #..#   #   ## ###.# #.......### #...........
......# #### # +   ## #...###.........# #...........
......####   ###   ## #...............###...........
.........# ###.###+####.............................
.........# #.....# #................................
.........# #.....# #................................
.........###.....# #................................
.................###................................
....................................................
