..........................................................
..........................................................
..........................................................
..........................................................
..........................................................
..........................................................
..........................................................
..........................................................
..........................................................
..........................................................
..........................................................
..........................................................
..........................................................
..........................................................
..........................................................
..........................................................
..........................................................
..........................................................
...................................###....................
...................................# #....................
...................................# #....................
...................................# #####.#######........
...................................#     ###     #........
............###..........#########.### #   # # # #........
..........### #..#####.### +   + ###.# # # # # # #........
..........#   #..#   #.#   #   #   #####+# # # # #........
..........# # #..# # ### # #   # # #     ### # # #........
.......#### # #..# # #   # #   ### +  <  #####+###........
.......# ## # #..# # # #######+#.# #     + #    #.........
.......# #### ####+### #...### #####+##### #    #####.....
.......# #.##+##   #   #...#     ### #...# #    +   #.....
.......# #.#   #   # ###...# # #   # ###.# +    # # #.....
.......#+###   # > + #...### # # # #   #.# #    # # ###...
.......#   #   +   ###...#   # # # # # #.###    # #   #...
.......#   #   #   #.##### # ####### # #...###### # # #...
.......#   +   #######     ###.# #   # ###......##### #...
.......#   #######.#   # # ##### # ###   ###........# #...
.......##+## +   ### # # # #     # #.###   #........# #...
........# ## #   #   # ##### # # # #...# # #####....###...
........# ## #   # # ###...# # #   #...# #   # #..........
........# ####   + # #.....# # ### #...# # # # #..........
........# #..#   # # #.....# # #.###...# # # # #..........
........# #..#   # ###.....#####.......##### # #..........
........# #..##### #.......................# # #..........
........###......###.......................#   #..........
...........................................#####..........
