......................................................
......................................................
......................................................
......................................................
......................................................
......................................................
......................................................
......................................................
......................................................
......................................................
......................................................
......................................................
......................................................
......................................................
......................................................
......................................................
......................................................
......................................................
......................................................
......................................................
......................................................
......................................................
...................#####..............................
...................#   #..............................
...................#   #..............................
...............##### < #..............................
...............#   +   #..............................
...........##### # #   #..............................
.........###     # #   #..............................
.........#   # # #######..............................
.........# # # # #....########..##########............
.........# ### # #..### +    #..# #      #............
.........# #.###+##.#   #    #..# #      #....###.....
.........# ###    ### # #    #..# #      #....# #.....
.........### +    #   # #    #..# ####+####.### #.....
...........# #  > + # # ##+######+###     ### # #.....
...........# #    # # #### ###      #     + # # #.....
...........# #############   +      +     # #   #.....
...........# #.......#     # #      #     # # ###.....
...........###.......# # ### ##+########+#### #.......
...................### # #.# ##     ##    ###+######..
...............#####   # #.# ## # # ##    #    +   ###
.........#######     # ###.# ## # # ##    +    # #   #
.......###       # # # #...#### # # ##+####    # # # #
.....###   # # # # # ###......##### ## #..#+#### ### #
.....#   # # # ### # #............#### #### #..###.# #
.....# # ### ###.# ###.............#     ## ###....# #
.....# # #.# #...# #...............# ### ##   #....# #
.....#####.###...###.............### #.# #### #....###
.................................#   #.# #..# ###.....
.................................# # #.# #..#   #.....
.................................# ###.###..### #.....
...............................### #..........# ###...
........................########   #..........#   ###.
........................#      # # #..........###   #.
........................#      # ###............# # #.
........................#      + #..............### #.
........................#      ###................# #.
........................########..................# #.
..................................................###.
