...........................................
...........................................
...........................................
...........................................
...........................................
...........................................
...........................................
...........................................
...........................................
...........................................
...........................................
...........................................
...........................................
...............................#########...
...............................#       #...
...............................# # # # #...
...............................# # # # ###.
...............................# ### #   #.
...............................# #.# # # #.
...............................###.# # # #.
................................######+# #.
..............................### #    # #.
..............................#   #    ###.
..............................# # +    ###.
............................### # #    + #.
............................#   # ###### #.
............................# # # #....# #.
..........................### ###+####.# #.
........................###   #.#    #.###.
.................########   # ###    #####.
.................#      # # # # +    +   #.
...............###    < # # ### #    # # #.
...............# +      #####.# ###### # #.
...........##### #      #######+###### ###.
...........#     #      + # +      # #####.
...........# # ######+### # #  >   #     #.
...........# # ##     #.# # #      + # # #.
...........# # ## # # #.# ###      # # # #.
.........### # ## # # ###   ########+#####.
.......###   # ## # #   ###   #      +   #.
...#####   ###### # ### ### # #      # # #.
...#     # #....### #.#   # # +      # # #.
...# # # ###......###.# # #####      # # #.
...# # # #............# # #...#      # # #.
.### # ###............### ###.####+### ###.
.#   # #................#   #..#   #####...
.# # ###................# # #..# #   #.....
.# ###..................### #### # # ###...
.###......................#   ######   #...
..........................### ###### # ###.
............................# #    # #   #.
............................# +    # # # #.
............................# #    ### # #.
............................####+###.#####.
...............................# #.........
...............................# #.........
...............................# #.........
...............................###.........
