.......###...............................
.......# #...............................
.......# #...............................
.......# #...............................
.......# #...............................
.......# #.......#####...................
.......# #.......#   #...................
.......#+######..#   #...................
.......#      ####   #...................
...###.#      + ###+######...............
...# ###      # ###      #...............
...#   +      #   #      ###.............
...# # #      # # #      + #.............
...# # #      ### +      # #.............
.###+############ #      # #.............
.#    #     #   # #      # #.............
.#    # # # # # # #####+## #.............
.#    + # # # # ###...# ####.............
.#    # # # ###   #...# #................
.######## # #.# # #...# #................
....#####+#####+# #...# ###..............
....#      #    # #...#   #..............
..###      #    ####### # #..............
### +  <   +    # +   ### #..............
#   #      #    + #   #.# #..............
# # ######+#    # #   #.# ###..#######...
# # #..#   #    ###   ### # #..#     #...
# ###..# # ######.#   + ### #..# # # #...
# #..### # ###....###+# #.# #..# # # #...
######   #   #......# # ###+#..# # # #...
.###   # # # ###....# # #   #### #####...
.#   # # # #   #....# # + > + ## #.......
.# # # ####### #....# # #   # ##+######..
.# # # #.....# #..### ####+## #     + ###
.# # # #.....# ####     ## ## +     #   #
.# #####.....# ##   ### ## ## #     # # #
.# #.........# ## # #.# ## ########## # #
.###.........#### # #.# ##   ###....### #
................# # #.# ####   ##########
................### #.###..# # #   + #...
..................###......# # #   # #...
...........................### +   # #...
.............................###   # #...
...............................#######...
