....................................................
....................................................
....................................................
....................................................
....................................................
....................................................
....................................................
....................................................
....................................................
....................................................
....................................................
....................................................
....................................................
....................................................
....................................................
....................................................
....................................................
....................................................
....................................................
....................................................
......................................###...........
....................###...............# #...........
....................# #...............# #...........
....................# #........#####..# #...........
....................# #......###   ####+#######.....
..................###+########   # #      +   #.....
..................#    #     # # # #      # # ###...
..................#    #     # # # +      # #   #...
................###    +     # # ###      ### # #...
..............### +    #     ### ########+#.# # #...
..............#   #    #     +      #.#   #.# # #...
..............# # ####+#     ###+####.# # ##### ###.
..............# # ##   #####+##   #...# #     #   #.
..............# # ## # # +    #   #.### ### # ### #.
..............# #### # # #    #   #.#   #.# # ### #.
..............###..# # # #    #   ### # #.###   # #.
...........######### #####    #   + # ###...### # #.
.........### +   #   #...#+####   # #####.....# ####
.........#   # < + ####### #..###+#     ###...# ## #
.........# # #   # #     # #..### # # #   ###.# ## #
.........# # #+### #     # #..#   # # # #   #.# ## #
.........### # #.# #     # #### # # # # # # #.#### #
...#######.# # #####     + ##   ######### # ###..# #
...#     #.###     #     #### # #.......###   ####+#
...#     ###   # # #     #### # #.........### #    #
...#     +   # # # ########   # #...........# #    #
...#     # # ### # #......# #####...........# + >  #
...#     # # #.# ###......# #...............# #    #
...####### ###.###........###...............###    #
.........###..................................######
....................................................
