............................................
............................................
............................................
............................................
............................................
............................................
............................................
............................................
............................................
............................................
............................................
............................................
............................................
..............................#####.........
..............................#   #.........
..............................#   #.........
..............................#   #.........
..............................##+###........
..............................#    #####....
..............................#    +   #....
................##########....#    # # #....
..............### +      #.######### # ###..
..............#   #    > #.#       # #   #..
..............# # #      #.# # # # ### # #..
..............# # #      ### # # #     # ###
............### # #      + # ###+#######   #
..........###   # ####+### ###      #..### #
..........#   # ###### #.#   #      ###### #
........### # ####   # #.# # +      +   ####
......###   # ## +   # ### # # <    # # ###.
......#   # #### #   +   #####      # #   #.
....### # ####   #   # #   #.##+##### ### #.
....#   #### # # ##+#### # #..# ######### #.
....# # #..# # #### #..# # ####         # #.
##### ###..# ####   #..# ####   # # # # # #.
#     ######+#### # #######   # # # # # # #.
# # ####      #   #     ### # # # # # # ###.
# # ## +      # # ### #   # # ### # ###   #.
# # ## #      + ###.# # # # ###.# # #.# # #.
# # ## #      # #...##### ###...#####.### #.
#################.......###.............###.
