...........................................................
...........................................................
...........................................................
...........................................................
...........................................................
...........................................................
...........................................................
...........................................................
...........................................................
...........................................................
...........................................................
...........................................................
...........................................................
........#####..............................................
..#######   #....###.......................................
..#     #   #..### ###...................###...............
..# # # #   #..#     #...................# #...............
..# # # + < #..# # # #.................### #...............
..# ### #   #..# # # #.................#   #...............
..# #.# #   #..###+####................# # #...............
..# #.#+#####..#      #...########.....# # #...............
..###.#    #.###      #...#    + #.....### #....###........
......#    ### +      #####    # #.......#+####.# #........
......#    #   #      +   + >  # ###.....#    #.# #........
......#    + # #      # # #    #   #######    #.# #........
......#    # # #      # # ####+###       #    ### #........
......#    # ####+##########     # # # # +    + #+######...
......########..# # +      # # # ### # # #    # #      ###.
.....### #......# # #      + # # ### # ###    # +      + #.
.....#   #......# # #      # ###   ### #.####+###      # #.
.....# # #......# ######+#####.# # #####....# ########## #.
.....# #+######## ###### #.....###     #..###   #......# #.
.....# #      #   ##   # #.......### # ####   # #####..###.
.....# #      # ####   + #.........# #   ## # #     #......
.....###      + ## +   ###.........# # # ## # # # # #......
.......#      # ## #+###...........### # ## ### # # ###....
.......#      # ## # #...............### ## #.# ###   #....
.......######## ## # #.................# ## #.###.### #....
..............###### #.................# ####.......# #....
...................# #.................###..........# #....
...................###..............................###....
