.........................................
.........................................
.........................................
.........................................
.........................................
.........................................
.........................................
.........................................
.........................................
.........................................
.........................................
.........................................
.........................................
.........................................
.........................................
.........................................
.........................................
.........................................
.........................................
..............................#####......
........##########............#   #......
........# #      #............# # #......
........# +      #............# # #......
........# #      #.......###..# # #......
.......##+########.....### #### # #......
.....###    #..........#     ####+###....
...### +    #..........# # # #      #....
...#   #    #..........# # # #      #....
...# # #    #..........### # +      #####
...# # ###+######......###+###      +   #
.### # #.#      ########    #######+# # #
.#   #####  >   #      +    + #...# # # #
.# ###   +      +      #    # ###.# ### #
.# #.# # #      #      ###+##   ### ### #
.# #.# # ###+#######+###.# ####   #   # #
.##### ##### #.###     #.# #..# # # # ###
.#   # #     #.# +     ### #..# # ### #..
.#   # # # # #.# #     + # #..# # #.###..
.#   ### # ##### #     # # #..### #......
.##+########     ##+#### ###....###......
.#     #.#   # #### #### #...............
.#     #.# # # ####   ## #...............
.#     ### ### ##   # ####...............
.# <   +   #.#### ###   ###..............
.#     # ###....# #.###   #..............
.#     # #......# #...# # ###............
.####+## #......# #...###   ###..........
###   ## #......# #.....# #   #####......
#   # ## #......###.....### #     #......
# # # ####................# # # # #......
# ###   #.................### # # #......
# #.### #...................### # #......
###...# #.....................#####......
......# #................................
......# #................................
......###................................
.........................................
.........................................
.........................................
.........................................
