...................................#######....
...................................#     ###..
...................................#     + #..
...............................#####     # #..
...............................#   +     # #..
...............................# # #     ###..
...............................# # #     #....
...............................###+########...
..............................###     +   #...
..........................##### +     # # #...
..........................#     #     # # #...
..........................# # # ######### #...
..........................# # # #.......# #...
..........................##### #...########..
.........#####...........######+#####      #..
.........#   ###.........#   #      #      #..
.........# #   #.........# # +      #      #..
.....###.# # # #.........# # #      +      #..
.....# #.# # # #.........### ########   >  #..
.....# #.# ### #..........##+#####..#      #..
.....# ###+### ############      #..######+###
######+#    #####   +     #      ###.....#   #
#      #    ##### # #     #      + ###...# # #
#      +    +     # # <   +      #   #...# # #
#      #    # # #####     #      # # ###.# ###
##+#####+#### # #...#     #      # #   #.# #..
.# #...# #### # #...#     ######+# # # #####..
.# #...# # ## # #######+###..#   # # #   #....
.# #.### # #######   #   ###.# # ##### # #....
.# ###   # #...# +   #   + #.# # #...# # ###..
.# #   ###+##### #   +   # ### # #...# #   ###
.### # ##      # #   ##+## #   # #...#####   #
...# # ##      # ###+## ## # #####.......# # #
...# # ##      + #   ## ## # #...........### #
...# # ##      # # # ## ## # #.............# #
...############### # ## ######.............# #
.................# #### #..................###
.................###..###.....................
..............................................
..............................................
