...........................................................
...........................................................
...........................................................
...........................................................
...........................................................
...........................................................
...........................................................
...........................................................
...........................................................
...........................................................
...........................................................
...........................................................
...........................................................
...........................................................
...........................................................
...........................................................
...................................###.....................
...................................# #.....................
...................................# #.....................
...................................# #.....................
...............................#####+####..................
...............................# +    # #..................
...............................# #    + #..................
...............................# #    # #..................
..................###......############ #.........###......
..................# #......#   #...####+###.......# #......
..................# #......#   #####      ######### #......
..................# #......#   +   +      + ##   ## #......
.................##+####.###   # # #      # ## # ## #......
.................#     #.# +   # # #####+## ## # ## #......
........###......#     ### #   # # #.#   #####+####+######.
........# ########     +   ###+# ###.# # ###   #.#     + #.
........#   ##   +     # ##### ###...# #   #   ###     # #.
........# # ## # ###+### ###   #...### # # #   + #   < # #.
........# # ## # ### #.# #   # #...#   # # +   # +     # #.
......###+########   ##### # ###...# # ### #   # #     # #.
......#      ###   #   #.# ###.....# ###.###   # #     # #.
......#      #   # ### #.# #.......# #.....#+#####+#######.
......#      + # ###.# #.# #.......###.....#   ### #.......
#######      # # #...# #####...............##+##   #.......
#     +      # # #...#   #.................#   # # #.......
# # # ###+###### #...# # #####.............#   # # #.......
# # # #   #....###...###     ###...........#   # ###.......
# # # # # #............# # #   #...........#   ###.........
# ### # # #............### # # #...........# > #...........
###.### # #..............##### #...........#   #...........
......# # #..................# #...........#####...........
......# ###..................# #...........................
......###....................###...........................
