.............................................
.............................................
.............................................
.............................................
.............................................
.............................................
.............................................
.............................................
.............................................
.............................................
.............................................
.......................................######
................................###....#    #
..............................### #....#    #
..............................#   #....#    #
..............................# # #....###+##
............................### #+######    #
............................#   #    # #    #
............................# ### <  # +    #
............................# #.#    + #    #
............................###.#    # ######
................................###### #.....
.................................#####+#####.
...................#######.......# #     + #.
.###...............#     #.......# +     # #.
.# #....#####......#     #.......# #     # #.
.# #....#   #....###     ###.....# ####+## #.
.# #....# # #..### +     + #...###+##.# ####.
.# #....# # ####   ###+### #####    ###   #..
.#+###.####+##   # ### #.#     #    #   # #..
.#   ###     # # # #   ### # # #    # # # ###
.# > + +     # # ### #   # # # +    # ###   #
.#   # #     + # #   # # ### # #    # #.# # #
.##### #     ##### ##### #.### #    # #.### #
.....# #     #...# #...###...###+######...# #
....#######+##...# #...........# #........###
....#     # #....# #...........# #...........
..###     # #..#######.........# #...........
..# +     + #..#     #.......### #######.....
### #     # ####     #...#####         ###...
#   #+#####   ##     #####     ### # #   #...
# # # #...### ##     +     # # #.# # # # #...
# # # ###...# ##     # # # # # #.# # # # #...
# ###   #...# ##     # # ### ###.# # # # #...
# #.### #...# ######## ###.# #...# # # ###...
# #...# #...###......# #...# #...#######.....
###...###............###...###...............
