...................................................
...................................................
...................................................
...................................................
...................................................
...................................................
...................................................
...................................................
...................................................
.#######...........................................
.#     #####.......................................
.#     +   ###.....................................
.#     # #   ###...................................
.####### # #   #...................................
.......# ### # #...................................
.......# #.# # #...................................
.....###+#########.................................
.....#      +    #.................................
.#####      ######............................###..
.#   +      #...............................### #..
.# # ####+#####.......########..............#   #..
.# # ## +     ###.....#    + #..............# # ###
.### ## #     + #...###    # ###............# #   #
...# ## #     # #...# +  < #   #######......# # # #
...########+### ##### #    ###       #......### # #
.....# +    #.###     #    #.# # # # #####...##+###
.....# #  > ###   # # ##+###.# # # #     ###.#   #.
.....# #    +   # # #### ##### # ### # #   ###   #.
.....# #    # # ### ##       #####.# # # #   +   #.
.##### ####+# # #.#### # # # #.....# # ### # #   #.
.#     #### # # #..### ### # ###...### #.# # ###+#.
.# # ####   # ###..#   #.# #   #.....# #.#####.# #.
.# # #### # ###..### ###.# # # #.#######.......# #.
.### ##   #   #..#   #...### # ###     #.......# #.
...#### # # # #..# # #.....###   +     #.......# #.
......# # ### #### # #.......### #     #.......# #.
......#####.#   ## ###.........# #######.......###.
............### ## #...........# #.................
..............# ## #...........###.................
..............# ####...............................
..............###..................................
