.......................................................
.......................................................
.......................................................
.......................................................
.......................................................
.......................................................
.......................................................
.......................................................
.......................................................
.......................................................
.......................................................
.......................................................
.......................................................
.......................................................
.......................................................
.......................................................
.......................................................
.......................................................
.......................................................
.......................................................
.......................................................
.......................................................
.......................................................
.......................................................
.........###...........................................
.........# #...#####...................................
.........# #...#   #...................................
.....###.# #...# # #...#############...................
.....# ###+###.# # #...# +   +     #######.............
.....#   #   #.# # #.### #   # # # #     #.............
...### # + < #.# # #.#   #   # # # #     #.............
...#   # #   #.# # ### # #   # ### +     #.............
...# # # #######+###   ###   # #.# #     #.............
.### # ###.#     ### # #.#   # #.###     #.............
.#   #+###.#     #   ###.##+####...#####+#.............
.# ###   #.#     # ######## #..........# #.............
.# # +   ###     + #..#   # ###........# #.............
.# # #   + +     # #..#   #   #........# #.............
.# # #   # #     # #..#   + # #........###.............
.#####   # #####+###..#   # # #........................
.....#+#####...#   #..##+## # ###......................
.....# #.....### # ####   ###   #......................
.....# #...###   # ## + > #.### #......................
.##### #.###   # #### #   #...# #......................
.#     #.#   # ###..# ##+###..# ###....................
.# # # ### # # #....# ##   #..#   #....................
.# # ###   ### #..### ## # #..# # #....................
.# # ### # #.# #..#   ## # #..### #....................
.# # #   # ######## #### # #....# #####................
.# # # # # ##       #..### #....#     #####............
.##### # #### # # # #....# #....# # #     #............
.....### ##   # # # #....###....### # # # #............
.......#### ### # # #.............### # # #............
..........# #.# #####...............# # # #............
..........###.###...................#######............
