......................................................
......................................................
......................................................
......................................................
......................................................
......................................................
......................................................
......................................................
......................................................
......................................................
......................................................
......................................................
......................................................
......................................................
......................................................
......................................................
......................................................
......................................................
......................................................
......................................................
......................................................
......................................................
......................................................
......................................................
......................................................
........................................###...........
........................................# #...........
........................................# #...........
........................######..........# #...........
........................#    #.......####+##..........
........................#    #####...#     #..........
......................### <  +   #...#     #..........
....................### +    # # #####   > ###........
....................#   ####+# #     +     + #........
..........#####.....# # ##   ### # # #     # #........
..........#   #.##### #### #   ### # #     # #.....###
..........# # #.#     #..# # # #.# # #####+# #.....# #
..........# # ### # ###### # # #######.### ###.....# #
........### # #   # #..#   # #   #.....#     ###...# #
........#   ### # # #..# # # # # #...### # #   ###.# #
....##### #+### ### #### ####### #...# # # # #   #.# #
....#     #   # #.# ##   #.....# ###.# ### # # # #.# #
..### # # #   + #.#### # #.....#   #.# #.# ##### ###+#
..#   # # #   ######   # #.....### #.#+######..# #   #
..# # # ###+###..#   # ###.......# ###      ######   #
..# # # #   #..### # ###.........#   #      #    #   #
..# # # # # #..#   # #...........### +      +    +   #
..# ##### # #..# # # #.............# #      #    #   #
..###...# # #### # # #.............###      ###+##   #
........###   ## #####...............#####+##.# ###+##
..........# # ####.......................# #### ### #.
..........### #######....................#   ##   # #.
............# #     #....................# # ## # # #.
............# #     #....................# # #### # #.
............# +     #....................### #..# ###.
............###     #......................# #..###...
..............#######......................###........
