..........................................
..........................................
..........................................
..........................................
..........................................
..........................................
..........................................
..........................................
..........................................
..........................................
..........................................
..........................................
..........................................
..........................................
..........................................
..........................................
..................................#####...
.....#####........................#   #...
.....#   #........................# # ###.
.....# # #........................# #   #.
.....# # #........................# # # #.
.....### #.......................####+# #.
.....###+######..................#    ###.
.....#    +   #....#####.......###  < ###.
.....#    # # #..###   #.......# +    + #.
.#####    # # #### +   #.......# #    # #.
.#   +    # # ##   #   ###.....# #    # #.
.# # #    ###### # #   + #####.# ###### #.
.# # #    #..#   ####+##     #.# #..# # #.
####+######### # #### ## # # ###+#### # #.
# +    #...#   # ##   ## # #   #   ## ###.
# #    #.### ### ## # ## # ### #   ## #...
# #    #.#   #.#### ########.# + > ## #...
#####+#### ###..#   #........# #   ##+##..
#   +    # #....# # #........###+###   #..
# # #    + ###### ###.###....### #.#   #..
# # #    ####     #...# #..###   ###   #..
# #####+##### # # #...# #..#   #   +   #..
# #.#   #.#   # # #...# #..# # ### #   ###
###.# # ### # # ###.###+##.# # #.# #   + #
....# # #   ### #...#    ### # #.# ##+## #
..### # # # #.# #...#    +   # #.# ## ## #
..#   ### # #.###...#    # # ###.#### ####
..# # #.#####.......###### ###......# #...
..# ###..................# #........# #...
..###....................###........###...
