................................................
................................................
...............###..............................
.............### #######..######................
.............#     #   #..#    #................
.............# # # +   ####+####................
.............# # # #   ##   #...................
..........#### # ########   #...................
..........# #### #..#   +   #...................
..........# #..#+####   #   ###.................
..........# ####    + < #   + #.................
.........##+## +    #   ##### #.................
.......###   # #    #   #...# #.....#######.....
.......# +   + #    #####...# #.#####     #.....
...##### #   # #    #.......###.#   +     #.....
...#   # #+### ###+########.....# # #     #.....
...#   ### #.# #.#      + #.....# # #######.....
...#   +   #######      # ###.#####+####........
...#   # #   ### +      #   ###      + #........
...#   # # # #   ####+### #   #      # #........
...##### ### # # #    #.### # +      # ###......
.......# #.# # # #    ####### #      #   #......
.......###.##### #  > #   + # ###+#### # #......
...............# #    +   # # #.# ###### #......
...............###    #   # # #.#   #..# #......
.................#    #   # ###.# # #### #......
.................##+#####+###.### #   ####......
................### #...# #...#   ###   #.......
................#   ###.# #.### ###.# # #.......
..............### #   #.# ###   #...# # ###.....
..............#   ### ###   # # #...# #   ###...
..............# # #.# #   # # ###...### #   #...
............### ###.# # ### # #.......### # #...
............#   #...# # #.# # #.........# # #...
............# ###...### #.#####.........### #...
..........### #.......# #.................###...
..........#   #.......###.......................
........### # #.................................
........#   ###.................................
........# # #...................................
........# # #...................................
........# ###...................................
........###.....................................
