.............................................
.............................................
.............................................
.............................................
.............................................
.............................................
.............................................
.............................................
.............................................
.............................................
.............................................
.............................................
.............................................
.............................................
.............................................
.............................................
.............................................
.............................................
....###......................................
....# #......................................
....# #......................................
....# #......................................
....# #......................................
....# #......................................
....# #......................................
....#+###....................................
....#   #####................................
....#   #   ###..............................
....#   + #   #...########...................
....#   # # # #...#      ###.................
....#   ###+# #####      + #.................
....#####   ###   +      # ###...............
......# + > ### # #      #   #...............
......# #   +   # #      # # #...............
..##### #   # # #####+#### # #...............
..#     #   # # ##### #..# # ###.............
..# # #####+#####   # ######   #.............
### # #.### ### +   #   #..# # #.............
#   # ###     # #   + # ###### #.............
# ### #   # # # #   # #   #..# ###.....###...
# #.# # # ### # ##+## ### #..#   #.....# #...
###.### # #.# # ## ####.# ###### ###...# #...
......#####.### ## #....#     ##   #...# #...
..............#### ###..### # ## # #####+###.
...............#     ###..# # ####   #     #.
...............# ###   #### #   ## # #     #.
...............# #.# #   ## # # #### +     #.
.............### #.# # # #### # #### #     #.
.............#   #.# ### ######   ##########.
...........### ###.###.#     #### #..........
...#######.#   #.......# # # #..# ###########
...#     #.# ###.......### # #..# #     +   #
...#   < ### #...........### #### +     # # #
...#     +   #.............#   ## #     # # #
...#     # # #.............# # ##############
...#     # # #.............### #.............
...###########...............###.............
