............................................
............................................
......###...................................
......# #........######.....................
......# #........#    #.....................
......# #......###    #.....#######.........
......# #......# +    #.....#     #.........
......# #......# #    #.....# # # #.........
......# #......# #    #.....# # # #.........
......#+########+######.....# ### #.........
......#      #     ###......# #.# #.........
......#      #     # #.######+#.# #.........
......#      +     # ###      #.###.........
......#      #     + # +      #.............
......##+#####     # # #      #.............
.......# #...#     # # #      #.............
.......# #...####### ###      #.............
.......# #........##+######+#####...........
.......# #........#      #    + #...........
.......###....#####      +    # ###.........
........###...#   +      #    #   #.........
........# #...# # #      ######## #####.....
........# #...# # #      #####..#     #.....
######..# #...# # ########   #..### # ###...
#    ####+#...# # #......#   #....# #   #...
#    #    #...### #......#   ###..### # #...
#    +    #..####+########   + #....### #...
#  < #    #..#      #   ##   # #......# #...
#    ##+###..#      #   ##   # #......# #...
#    ## #....#      +   ###+## ###....###...
###+### #..###   >  #   #   ##   #..........
#    ## #..# +      #   #   #### #..........
#    ####### ####+###   +   + ## #..........
#    +       ##   #.###+#   # ## ###........
#    # # # # ## # #.#   ##### ##   #........
###### # # #### # #.# # ###.# ## # #........
.....### # #..# # ### #   ### #### ###......
.......# ###..### #   # #   # #..#   #......
.......# #......### ### # # ###..# # #......
.......###........# #.### # #....# # #......
..................# #...# # ###..### #......
..................###...# #   #....# ###....
........................##### #....#   #....
............................# #....### #####
............................###......#     #
.....................................# # # #
.....................................# # # #
.....................................# # # #
.....................................##### #
.........................................# #
.........................................###
............................................
