...........................................................
...........................................................
...........................................................
...........................................................
...........................................................
...........................................................
...........................................................
...........................................................
...........................................................
...........................................................
...........................................................
...........................................................
...........................................................
...........................................................
...........................................................
...........................................................
...........................................................
...........................................................
...........................................................
...........................................................
...........................................................
...........................................................
...........................................................
...........................................................
...........................................................
.........................#########.........................
.......................### +   + ###.......................
.......................#   # < #   #.......................
...........#######...### # #   # # #.......................
...........#     #####   #####+### #.......................
...........#     +   # ### +     #######...................
...........#     #   # #.# #     +     ###.................
...........#######   + #.# #     # # #   #.................
..............####   # #.# #     # # # # #.................
..............# ##+####### #     # # # # ####..............
..............# ## #.#     ###+### ######## #..............
..............# ## #.# # ##### #.#### #.### #.......#####..
..............# ## #.# # #.#   #....# #.# # #####...#   #..
..............# ## ### # #.# # ###..# #.# #     ###.# # #..
..........#####+## #   # ### #   ####+### # # #   #.# # #..
..........#      # # # ###   # #   #    #   # # # #.# ###..
..........#      ### ##### # # # # +    # ##### # ###+####.
..........#      +   #.#   ##### # #    # #...# # #    + #.
........###      # # #.# ###...# # ###+##+#########  > # #.
........# +      # ###.# #.....### #   #      +   +    # #.
....##### ######## ##### #.......### # #      # # #    # #.
..###     #......# #     #.......#   # +      # # ########.
..#   # # #......### # # #.......# # ###      # ###........
..# # # # #........# # ###.......# # #.######## #..........
..# ##### #........# ###.........# # #........###..........
..###...###........###...........#####.....................
