...........................................................
......................###..................................
......................# #..................................
......................# ###................................
......................#   #................................
.................###### # #................................
.................#    # # #................................
.................#    # # #................................
.................#    #+#####..............................
.................#    +     #..............................
.................#    #     ###............................
.................#    #     + #............................
................###+###     # #............................
..............###    ######## #............................
............### +    #......#+###..........................
............#   #    ###....#   #..........................
............# # #    # ######   #..........................
............# ###+#### #    +   ###........................
.....###....###.# #..# +    #   + ######...................
.....# #........# #### #    #   #   ## #...................
.....# ########## ##   ########## # ## #...................
.....# #      # # ## # #.#      ### ## #...................
.....# +      # # ## #+###      #.#### #...................
.....# #      # # ## #   #      ######+#####...............
.....#+########+###### < +      + #      + #...............
.....#     ###   ### +   #      # #      # ###.............
...###     # +   +   ###+#+###### +      #   #.............
...# +     + #   # # #.# # #....###   >  # # #.............
...# #     # ##+## # #.# # #......#      # # ###...........
...# ##+#### ## ######.# # #################   #...........
.### ## #..#### #......# #   #      + #....# # #...........
.#   ## #.##### #....### ### #      # #....### #...........
.# #### #.#     #....#     # +      # #......# #...........
.# #..# #.# # ######## ### # #      ###......# ###.........
.###..###.# # ####     #.# # #      #........#   #.........
..........# ####   # ###.########+###........### #.........
..........# #..# # # #..........#   #..........# #.........
..........# #..# # # #..........# # #..........###.........
..........###..##### #..........# # #......................
...................# #..........#####......................
...................###.....................................
