..........................................................
..........................................................
..........................................................
..........................................................
..........................................................
..........................................................
..........................................................
..........................................................
..........................................................
..........................................................
..........................................................
..........................................................
..........................................................
..........................................................
.....................................................###..
.....................................................# #..
.....................................................# #..
.....................................................# #..
.....................................................# #..
.....................................................# #..
.....................................................# #..
.........................................###.###...### #..
.........................................# #.# #...#   #..
..........................#######........# #.# #####+###..
...............###........#     #........# #.#   #    #...
...............# #..#######     ###......# #.# # #    #...
...............# #..#     +     + #####..# ### # + <  #...
...............# #..# # # #+#####     ####     ###    #...
...............# #..# # # # ###.# # #   ######+#.#    #...
...............# #### # ###   #.# # # # #      ######+###.
............####+##   # #   # #.# # # # #      + #      #.
............# +   # ##### # # ####### # +      # #  >   #.
............# #   + ###   ### # ###.# ###      # #      #.
............# #   ###   # #.# #   #.###.###+#### #      #.
..........### ####### # # #.#   # #.......# #..# #      #.
........###   ###     ### #.##### ###.....# #..#####+####.
........#   ###   # # #.###.....#   #.....# #......# ###..
######### # #   # # # #.........# # ##########.....#   #..
#         ### # # # ###.........###   #    + ###.### # #..
# # # # ###   # # # #.............### +    #   #.#   # #..
# # # # ### # # # # #...............# #    # # #.# ### #..
# # # # #   # #######...............######## # #.# #.# #..
### # # # # # #............................# # #.# #.# #..
..##### # # ###............................# # #.# #.###..
......### # #..............................### #.# #......
........#####................................###.###......
..........................................................
