............................................
............................................
............................................
............................................
............................................
............................................
............................................
............................................
............................................
............................................
............................................
............................................
............................................
............................................
............................................
............................................
............................................
............................................
..............#####.........................
..............#   #.........................
..#######...### # #######...................
..#     #####   #       #...................
### # #   #   # # # # # #...................
#   # # # # # #+### # # #...................
# ### # # # # #   # # # #...................
# #.# # # # # #   ########..................
# #.# ####### # > #      #..................
#####+###...###   +      #..................
..# +   ##### +   #      ###................
### #   +     #   #      + #................
#   #   # # # #+###      # ###..............
# # ##+## # # # #.#      #   #..............
# #### ## # ### #.#+###### # ###....#####...
###..# ## # #.# ### ###..# #   #....#   #...
...### ## # ### #     #..# # # #....# # #...
...#   ######   # # # #..##### #....# # #...
.### # #..### # # # # ######## #....# # #...
.#   ###..#   #######       ## ###.##+####..
.# # #....# # #.....### # # ##   ###     ###
.# # #....# # #.......# # # ####   #     + #
.# ###....# # #.......# # #   ## # +   < # #
.# #..##### ###.......# ### # ## # #     # #
.###..#     #.........# #.# # #########+## #
......# # ###.........###.### #####...# ## #
....### # #.................#     #.### ####
..###   ###.................### # #.#   #...
..#   # #.....................# # #.# # #...
..# # ###.....................### #.# # #...
..# ###.........................# #.# # #...
..###...........................###.#####...
