..........................................
..........................................
..........................................
..........................................
..........................................
..........................................
..........................................
..........................................
..........................................
..........................................
..........................................
..........................................
..........................................
..........................................
..........................................
..........................................
.................................###......
.................................# #......
.................................# #......
.................................# #......
...............................###+###....
...............................#   # #....
...............................#   # #....
..........#######..............#   + #....
........###     #.######.......#   # #....
......###   # # #.#    #.......#####+###..
....###   # # # ###    #..........#    #..
..###   # # # # # +    #..........#    ###
..#   # ### # ### #    #..........#    + #
..# # # ###+###   #    ###........#    # #
..# # # # +   # # #    + ###...######+## #
### # # # # < # # ###+##   #...#      ## #
#   # ### #   + # #   ## # ###.#      ####
# # ###.###   # ### # ####   #.#      #...
# ###....###### #.# #   #### ###      #...
# #......#    ###.# # # ####   ####+###...
# #....###+######## # #   ## #   #    ###.
###....# +      #   ##### ## # # + >  + #.
...##### #      + ###...# ###### #    # #.
...#     #      # #.....###....#####+## #.
...# # # ######+# #.........######.# #####
...# # ###....# # #.........#    ###     #
.### ###..##### ###.........#    +   # # #
.#   #....#       ###.......#    # # # # #
.# ######## # # #   ###.....###### # # # #
.# #..#     # # # #   #..........# # ### #
.# #..# # # ### # # # #..........# ###.# #
.# #..# # ###.### # # #..........# #...###
.###..#####.....#######..........###......
