...........................................
...........................................
...........................................
...........................................
...........................................
...........................................
...........................................
...........................................
...........................................
...........................................
...........................................
...........................................
...........................................
...........................................
...........................................
...........................................
...........................................
...........................................
.............................###...........
...........#######...........# #...#####...
...........#     #...........# #.###   #...
...........#     #...........# #.#   # #...
...........#     #.......###.# ### # # #...
...........#     #.......# ### # # ### #...
...######..#     #.......# #     ###.# #...
...#    ######+###.......# # ### #.###+###.
.###    #      #.........# # #.# ###     #.
.# +    +      #........##+###.#   #     #.
.# #    #      ##########   #..# # #     #.
.# ######      + #      #   ####+# +     #.
.###....#      # #      #   #    ###     #.
........#      # #      +   # <  ###     #.
........######## #      #   +    + #######.
.....###########+##+#####   #    #   #.....
.....# +   # +    # ######+##    # # #.....
.....# #   # #    #   ##   #####+### #.....
.....# #   + #    + # ## #   #.# #.# #.....
.....###   ###    ### ## # # #.# #####.....
.......#   #.#    #.# ## # # ###     ###...
....####+#######+#### ## # # #   # #   ###.
....# +   #.#      ## #### ### # # # #   #.
....# # > ###      ####..###   ####### # #.
....# #   # +      #.......# # #.....# # #.
....# #   # ####+########### ###.....# # #.
....####### #### ###      ## #.......### #.
........#   ##     #      ## #.........###.
........# # ## # # +      ## #.............
#####...# # ## # # #      ####.............
#   ##### ###### # #      #................
#   #     #....#####+######................
#   # # ###........# #####.................
#   + # #..........#     #.................
#   # # #..........# # # #.................
#   ### #..........### # #.................
#####.###............# # #.................
.....................# # #.................
.....................#####.................
