......................................................
......................................................
......................................................
......................................................
......................................................
......................................................
......................................................
......................................................
......................................................
......................................................
......................................................
....................................###...............
....................................# #...............
....................................# #...............
....................................# #...............
...........................###......# #...............
.......................##### #......# #...............
.......................#     #....###+############....
.......................# # # #....#      #   +   #....
.....................### # #+######      +   # # #....
.....................#   # #      +      #   # # #....
.....................# # # #      #      #+### # #....
...................### # ###      #+######   ### #....
...................#   ###.#      #     ## # #####....
...................# ###...#      # # # ## #   #......
...................# #.....#      # # # #### # #......
...................# #.....####+##### ######## #......
...................###........#     ###   #..# #......
.......................########     #.# # #..# #......
.......................#      +     #.# # #..# #......
.......................#      #     ### # #..###......
.......................#   >  #     + #+###...........
.....................###      #+##### #   ###.........
...................### +      #   ### #   + #.........
.................###   ###+#### #   # + < # ###.......
.................#   # #     ## # # # #   #   #.......
.................# # # # # # ## ### ###+##### ####....
...............### # # # # # ## #.#   # ###.# ## #....
...............#   # ### ########.# # #   #.# ## #....
.............### # ##### #........### # # #.#### #....
.............#   ###.#   #..........### # ###.##+###..
.............# ###...# ###............###   #.#    #..
.............# #...### #................### ###    #..
.............# #...#   #..................#   #    #..
.............# #...# ###..................# # +    #..
.............# #.### #....................# # #    #..
.............###.#   #....................### #    #..
...............### # #......................# #+####..
.............###   ###......................# # #.....
...........###   # #........................### #.....
...........#   # # #..........................# #.....
...........# # # ###..........................###.....
...........# # ###....................................
...........# # #......................................
...........# ###......................................
...........# #........................................
...........###........................................
