.....................................................
.....................................................
.....................................................
.....................................................
.....................................................
.....................................................
.....................................................
.....................................................
.....................................................
.....................................................
.....................................................
.....................................................
.....................................................
.............................###.....................
.............................# #.....................
.............................# #.....................
.............................# #.....................
.............................# #.....................
.............................# #.....................
......................########+###...................
....................###    #     #...................
................##### +    #     #...................
................#     #    +     ###.................
............##### # # ####+#     + #.###.............
............#     # # #..# #     # #.# #.............
............# # ### # #..# ####+## #.# #.............
............# # #.### #..# ##   ####.# ###...........
..........### ####.##+####### # #....#   #...........
..........#   ## ###    ##### # ######+# #...........
........### #### # +    #   ### #      # #...........
........#   #..# # #    #   #####      ###...........
........# # #..# # #    +   +   #      #.............
........# # #..# ###    ###+# # +      ###...........
........#####..# #.#    ### # # #      + #...........
............####+####+###   # # #      # #####.......
............# +   #     # # # ###+######     #.......
............# #   #     # # ###.# #....# # # ###.....
............# #   +     # # ##### #....### #   #.....
............# #   #     # ###   # #......# # # ###...
............# #####     ###.# # # #......# # #   #...
............# #..###+####...# # # #......# ### # #...
............######     #....# # # #......###.# # #...
...............#   # # ########+#####........### #...
...............# # # # #      #   + #..........# #...
...............# # ### +    > #   # #..........# #...
...............# # #.###      +   # ###........###...
...............### #...#####+##   #   #..............
.................###.####### ###### # #..............
................######     #   #..### #..............
................#    #  <  + # #....# #..............
..............###    +     # # #....###..............
..............# +    ######### ###...................
..............# ######.......#   #...................
..............# #............### #...................
..............# #..............# #...................
..............###..............###...................
