...........................................
...........................................
...........................................
....................###....................
....................# #....................
....................# #....................
....................# #....................
....................# #....................
....................# #....................
....................#+###..................
....................#   #..................
....................#   #..................
....................#   #..................
....................#   #..................
....................#   #..................
....................#   #..................
....................##+######..............
.....................#      #..............
.....................#      #####..........
.....................#      +   #..........
.....................#      # # #....#####.
.....................######## # #....#   #.
............................# # #....# # #.
..........................###+###....# # #.
..........................#   #......# # #.
.................##########   #...####+###.
...............###      + # < #...#    ###.
...............# +      # +   ###.#    + #.
.............### #      # #   + ###    # #.
...........###   #      # #   #   +    # #.
...........#   # #      ###+### # #    # #.
...........# # # ###+####.# #.### #    # #.
...........# # ####   ###.# #...#####+## #.
.........### ###..#   + ### #.......# ####.
....######   #..###   #   # ###.....#   #..
....#    # # #..# +   # # #   #...### # #..
....#    # ###### ##+#### ### #...# ### #..
..### >  + #..#   ## #..#   # #...# #####..
..# +    ###..# # ## #..### # ###.#   #....
..# #    #....# #### #....# #   #.# # #....
..# ########### ##   #....# ### ### # #....
..# #.....#     ## # ###..# #.#   #+######.
..# #...### # #### #   #### #.# # #      #.
..# #.###   # #### ###   ####.# # +      #.
..###.#   ######   #.# # #....#####      #.
......# # ###### ###.# # #........####+###.
......# # ##     #...### #####.....#   #...
......# # ## # ###.....#     #.....# # #...
......###### # #.......### # #.....# # #...
...........#####.........# # #.....### #...
.........................#####.......###...
