..................................................
..................................................
..................................................
..................................................
..................................................
..................................................
..................................................
.........................#####....................
.........................#   #....................
..................#####..#   ###..................
..................#   #..#   + #..................
..................# # ####   # #..................
..................# # # ###### #..................
................### #     #..# #..................
................#   ### # ####+##.................
................# ###.# # #     #.................
................# #...# # #     #.................
................# #####+###     #.................
................# ##      +     #.................
.........###########      #     ###...............
.........#         +  <   #     + #...............
.........# # # # # #      ####### #...............
.........# # # # # ##########...# #...............
.........#######+#####      #...# #####...........
.............###     #      ###.# #   #...........
.............# +     +      + #.### # #...........
...........### #     #      # #...# # #...........
.........###   ########+##### ###.# # #...........
.........#   # #.# +      #.#   ###+###...........
.......### # ###.# #  >   ### # #   + #...........
.......#   # #...# #      + ### #   # ###.........
.......# # ###.### ####+### #.# +   #   #.........
.......# # #...#   ##   ### #.# #   ### #.........
.......#####...# # ## #   # #.# ###+#.# #.........
.............### #### # # # #.###.# ### #.........
.............#   ##   ### ###.....#   # ###.......
.............# #### ###.# #####.### # #   #.......
...........### ##   #...#     #.#   # ### #.......
.........###   ## # #...# # # ### # #   # ###.....
.......###   #### # #...### # #   # # # #   #.....
.......#   # #..### #.....# # # # ##### # # #.....
.......# # # #....###.....# # # ###...# # # #.....
.......# ### #............#######.....# #####.....
.......###.# #........................# #.........
...........###........................###.........
