.........................................
.........................................
.........................................
.........................................
.........................................
.........................................
.........................................
.........................................
.........................................
.........................................
.........................................
.........................................
.........................................
.........................................
.........................................
.........................................
.........................................
.........................................
.........................................
.........................................
.........................................
.........................................
.........................................
.........................................
.........................................
.........................................
.........................................
.........................................
.........................................
..................#####..................
................###   ###................
..............### +   + #................
..............#   #   # #................
..............# # # > # ###..............
............### # #   #   #..............
..........###   # ##+#### #####..........
..........#   # # ##   ##     #..........
..........# # # #### # #### # ###........
..........# # ####   #   ## #   #........
........### # #..# ##### ###### ###......
........#   # #### #...#   #..#   #......
......### ######   #...# # #### # #......
......#   #....# # #...# #   ## # #####..
....### ###..### # #...# # # ####   # ###
....#   #....#   ###...### # #### # #   #
....# # #..### # #.......# #   #### # # #
..### # #..#   # #.......#####   ## # # #
..#   # #..# #####...........# # ####+###
### # ###..# #...............# #   #   #.
#   # ###### #...............# ### #   #.
# # ####     #...............# #.# #   #.
# # #..# # ###...............###.# + < #.
# ###### # #.....................###   #.
# ##     ###.......................#   #.
# ## # # #.........................#####.
#### # # #...............................
...### ###...............................
.....###.................................
