................................................
................................................
................................................
.................................######.........
.................................#    #.........
..............................####+####.........
............................###      ###........
............................# +      + #........
............................# #      # #########
............................# ########   #     #
............................# #......# # #  >  #
............................###......# # +     #
...................................###+###     #
.................................### #   #######
.................................#   +   ###....
.................................# # #   + #....
.................................# #+##### #....
.................................# #     # ###..
.............................#######     #   #..
.............................#     +     # # #..
.............................# # # #     ### #..
......................######## # # #     #.###..
....................###   + ## # # #####+##.....
..................### +   # ## # # #.#    #####.
..................#   #   # ## ###+###    +   #.
..................# # ###+#######   ##    # # #.
....#####.#####.### ###.#   #.###   ##+#### # #.
..###   #.#   #.#   #...# # #.# +   ## ###### #.
..#   # #.# # #.# ###...# # #.# #   ##   #..# #.
..# # # #.# # #.# #.##### # ### #+#### # #..###.
..# # ###.### #.# #.#     #     # #..# # #......
..### #...###+### ### # ##### ### #### # #......
.####+#.###   #   #   # #...# #     #### #......
.#    ### + < + ### # # #...# # ### #..###......
.#    +   #   # #.# ### #...# # #.# #...........
.#    # # #+### ### #.###...### #.# #...........
.###### ###   # #   #.........# #.# ###.........
......# #.# # ### ###.........###.#   #.........
......# #.# # #.# #...............### #.........
......###.### #.# #.................# #.........
............###.###.................###.........
................................................
