.....................................................
.....................................................
.....................................................
.....................................................
.....................................................
.....................................................
.....................................................
.....................................................
.....................................................
.....................................................
.....................................................
.....................................................
.....................................................
.....................................................
............###......................................
............# #......................................
............# #......................................
............# #......................................
............#+###....................................
..........###   #....................................
....#####.# #   #....................................
....#   ### +   #....................................
....# # #   #   #####................................
....# # # # #   #   ###..............................
....# ### # ##### #   #####..........................
.####+##### #...# # #     #..........................
.# +      #+##### # # # # #..........................
.# #      +     ### ### # #..........................
.# #      #     ###+#######..........................
.# #+######     #     ########.......................
.### ###..# <   +     #      #.......................
...#   ####     #     +      ###.....................
...# #   ##     #     #      + #.....................
.### # # #####+###+####      # #######...............
.#   # # ##      # #..###+####       #...............
.# ### # ##      # #..### #### # # # ###.............
.# #.# # ##      # ####     ## # # #   #.............
.# #.################   # # ## # ##### #.............
.# #....# #...#####   # ### #### #...# #.............
.###....# #####     # # #.# #### #...# #.............
........# #     # # # ###.#   ####...# #.............
.....####+# # # # # # #...###   #....###.............
.....#    # # ### ### #.....# # #....................
...### >  + ###.###.###.....# # ###..................
...# +    # #...............# #   ###................
...# ####+###...............#####   ###..............
.### #### ###...................# #   #..............
.#   ##     #...................# # # #..............
.# #### # # #...................### # ###............
.# #..# ### #.....................# #   #............
.# #..# #.# #.....................### # ###..........
.# #..# #.# #.......................# #   #..........
.# #..# #.# #.......................### # #..........
.###..###.###.........................### #..........
........................................# #..........
........................................# #..........
........................................# #..........
........................................###..........
