...............................................
...............................................
...............................................
...............................................
...............................................
...............................................
...............................................
...............................................
...............................................
...............................................
...............................................
...............................................
...............................................
...............................................
...............................................
...............................................
...............................................
...............................................
.......#######.................................
.......#   # #.................................
.......# # # #.................................
.......# # # #.................................
.......# # # #.................................
...#######+# #.................................
...# +     #+####..#########...................
.### #     #    #### +   + ###.................
.#   #     +    + ## #   #   #.................
.# ###     #    # ## # < # # #.................
.# #.####+####### ## #   # # ###...............
.###..###   #...# ## #+#####   #...............
......#   # #####+#### #...# # #...............
....### # # ##     #.# ###.### #...............
....#   # ####     ###   #...# #####...........
....# # # ## +     +   # #...#     ###.........
....# # #### #     # # # #...### #   #.........
....### ##   #     # ### ####### # # ###.......
......#### #######+###.#       # ###   #####...
.....###   #...### #...# # # # # #.###     #...
...###   # #.###   #...### # # ####### # # #...
...#   # # ###   # #.....### ###..# #### # ###.
.### # ### #   # # #####...###....# #..# #   #.
.#   ###.### # ###     ############ #..# ### #.
.# ###.....# # #.# # #       #    # #..###.# #.
.# #.####### # #.### # # # # #    #+#####..# #.
.###.#     # ###...# ### # # +    #     #..# #.
.....#     + #.....# #.#######    +  >  #..# #.
.....#     ###.....###.......#    #     #..###.
.....#######.................############......
