.................................................
.................................................
.................................................
.................................................
.................................................
.................................................
.................................................
.................................................
.................................................
.................................................
.................................................
......................................###........
...#####..............................# #........
...#   #..............................# ###......
...# # #..............................#   #......
...# # #...........................####+# ###....
...### #.........................###    #   #....
.....# #.........................# +    ### #....
.....#+#####.....................# #    #.# #....
.....#     #.....................# ###+#### #....
.....#     #.....................###   + ####....
.....#  >  ###...................# +   #   #.....
.....#     + #....##########.....# #   # # #.....
.....#     # #....# +      #####.# ####### #.....
.....#     # #..### #      +   #.#+####..# #.....
.....#######+####   #      # # ###    #### #.....
....###   +   #   # #      # #   +    + ## #.....
....#   # #   # # ######+### # # #    # ####.....
....# # # #   # # #....# #.# ### #+####   #......
....# #####   + # #....# #.###.# # #..# # #......
....# #...# < ### #..### ###...# # #### # ###....
....# #...#   #.######     #...###   ## #   #....
....###...##+##..###   # # ######### #### # ###..
.........### #...#   # ###       #.# #..# #   #..
..######.#   #...# # ###.# # # # ### ###### # #..
###    ### # #...# ###...# # # #   #     #### #..
# +    #   # #.### #.....### # # # ### # ######..
# #    + # ###.#   #.......##### # #.# #   #.....
# #    # ###...# ###...........# # #.# # # #.....
###    # #...### #.............### #.# ### #.....
..###### #...#   #...............###.###.# #.....
.......# #...# ###.......................###.....
.......###...# #.................................
.............###.................................
