.....................................................
.....................................................
.....................................................
.....................................................
.....................................................
.....................................................
.....................................................
.....................................................
.....................................................
.....................................................
.....................................................
.....................................................
.....................................................
.....................................................
.....................................................
.....................................................
.....................................................
.....................................................
.....................................................
.....................................................
.....................................................
.....................................................
.....................................................
.....................................................
.....................................................
.....................................................
.....................................................
.....................................................
...............###...................................
..###..........# #...................................
..# #..........# #....#######........................
..# #..........# #..### +   ###......................
..# #..........# #..#   #   + #......................
..# #..........# #### # # > # #......................
..# #.......####+##   # #   # #......................
..#+#####.###     # ### ##+## #####..................
###     #.# +     # #.#### ##     #..................
# + <   ### #     # #..### #### # #..................
# #     +   #     + ####     ## # #..................
# #     # # #     # ##   # # ## # ###................
# ####### ###     #### # ### ####   #................
# #### ####.###+###..# ###.# #### # ###..............
# ##   #..###     #### #...#   ####   #..............
#### # #### +     + ## #...###   ## # #..............
...# # ##   #     # ####.....# # ## # #..............
######+## # #     #   #......# # ## # #..............
# +     # # #     ### #......# # #### ###............
# #     # # #     #.# #......# ###..#   #............
# #     + # ###+###.# #......###....### ###..........
# #     #####.# #...# ###.............#   #..........
# #######.....# #...#   #######.......# # #..........
###.#######...# #...###       #.......# # #####......
....#     #.### #.....# # # # ###.....###     #......
..###     ###   #####.# # # #   #.......# # # #......
### +     +   #     #.# ### ### #.......### # #......
#   #     # # ### # #.###.# #.# #.........### #####..
# # #     # ###.# # #.....###.# #...........#     #..
# ######### #...### #.........###...........# # # #..
###.......# #.....###.......................### # #..
..........###.................................#####..
