................................................
................................................
................................................
.................######.........................
.................#    #.........................
.................#    #.........................
.................#    ###.......................
.................#    + ###.....................
.................#    #   #.....................
.................#    # # ###...................
.................###### #   ###.................
......................# # # # #.................
...................####+### # #.................
...................#      # # #.................
...................#      ### #.................
.....###...........#      ###+###...............
.....# #...........#      +     #...............
.....# #...........#      #     #...............
.....# #...........#      #     ##########......
.....# #....###############     +   ##   #......
.....# #....#     +     #####+### # ## # #......
....##+####.# # # #     #     # # # ## # #......
....#     ### # # #   < +     + # ###### #......
....#     #   # # #     #     # # ######+##.....
..###     + # ### #############+####      #.....
..# +     # # #.##############     #      #.....
..# ####### ###....# +     + #     +      #.....
..# #....######..### #     # +     #      #.....
..###....#    ####   #     # #     ########.....
.........#    ##   # #     # #####+###..........
.........#    ## # # ####### #.#     ##########.
.........###+### # # #.....# #.#     #    +   #.
.......### +   # #####.....###.#     +    # # #.
.......#   #   + #.............#   > #    # # #.
.......# # #   # #.............#     ##+### ###.
.......# ###+#####.............##+##### #.###...
.......# #.# #................###   #.# #.......
.......# #.# #................#   # ### ###.....
.......# #.# #................# # #   #   #.....
.......##### ###..........##### # # # ### #.....
.........#     #........###     # # # ### #.....
.......### # # #........#   # ### ###   # #.....
.......#   ### #........# # # #.###.### # #.....
.......# # #.# #........# # # #.......# ###.....
.......# ###.# #........# # ###.......# #.......
.......# #...###........# # #.........# #.......
.......# #..............# ###.........# #.......
.......# #..............###...........###.......
.......###......................................
................................................
................................................
